💜💜💜🚙🚙🌿🌝🌝📙📙📙🎒🎒🎒🎒🎒🎒🎒🎒🎒🎒🎒🎒🎒🎒🎒🎒🎒🎒📙📙📙🌝🌝🌿🌿🚙🚙💜💜💜🚙🚙🌿🌿🌝🌝📙📙🎒🎒🎒🎒🎒🎒📙📙📙📙📙📙📙📙📙📙📙📙🎒🎒🎒🎒🎒🎒📙📙🌝🌿🌿🚙🚙
💜💜💜🚙🚙🌿🌝🌝📙📙📙🎒🎒🎒🎒🎒🎒🎒🎒🎒🎒🎒🎒🎒🎒🎒🎒🎒🎒📙📙📙🌝🌝🌿🌿🚙🚙💜💜💜🚙🚙🌿🌿🌝🌝📙📙🎒🎒🎒🎒🎒🎒📙📙📙📙📙📙📙📙📙📙📙📙🎒🎒🎒🎒🎒🎒📙📙🌝🌿🌿🚙🚙
💜💜💜🚙🚙🌿🌝🌝📙📙📙🎒🎒🎒🎒🎒🎒🎒🎒🎒🎒🎒🎒🎒🎒🎒🎒🎒🎒📙📙📙🌝🌝🌿🌿🚙🚙💜💜💜🚙🚙🌿🌿🌝🌝📙📙🎒🎒🎒🎒🎒🎒📙📙📙📙📙📙📙📙📙📙📙📙🎒🎒🎒🎒🎒🎒📙📙🌝🌿🌿🚙🚙
💜💜💜🚙🚙🌿🌝🌝📙📙📙🎒🎒🎒🎒🎒🎒🎒🎒🎒🎒🎒🎒🎒🎒🎒🎒🎒🎒📙📙📙🌝🌝🌿🌿🚙🚙💜💜💜🚙🚙🌿🌿🌝🌝📙📙🎒🎒🎒🎒🎒🎒📙📙📙📙📙📙📙📙📙📙📙📙🎒🎒🎒🎒🎒🎒📙📙🌝🌿🌿🚙🚙
💜💜💜🚙🚙🌿🌝🌝📙📙📙🎒🎒🎒🎒🎒🎒🎒🎒🎒🎒🎒🎒🎒🎒🎒🎒🎒🎒📙📙📙🌝🌝🌿🌿🚙🚙💜💜💜🚙🚙🌿🌿🌝🌝📙📙🎒🎒🎒🎒🎒🎒📙📙📙📙📙📙📙📙📙📙📙📙📙🎒🎒🎒🎒🎒📙📙🌝🌿🌿🚙🚙
💜💜💜🚙🌿🌿🌝🌝📙📙🎒🎒🎒🎒🎒🎒🎒🎒🎒🎒🎒🎒🎒🎒🎒🎒🎒🎒🎒📙📙📙🌝🌝🌿🌿🚙🚙💜💜💜🚙🚙🌿🌿🌝🌝📙📙🎒🎒🎒🎒🎒🎒📙📙📙📙📙📙📙📙📙📙📙📙📙🎒🎒🎒🎒🎒📙📙🌝🌝🌿🚙🚙
💜💜💜🚙🌿🌿🌝🌝📙📙🎒🎒🎒🎒🎒🎒🎒🎒🎒🎒🎒🎒🎒🎒🎒🎒🎒🎒🎒📙📙📙🌝🌝🌿🌿🚙🚙💜💜💜🚙🚙🌿🌿🌝🌝📙📙🎒🎒🎒🎒🎒🎒📙📙📙📙📙📙📙📙📙📙📙📙📙🎒🎒🎒🎒🎒📙📙🌝🌝🌿🚙🚙
💜💜🚙🚙🌿🌿🌝🌝📙📙🎒🎒🎒🎒🎒🎒🎒🎒🎒📙🎒🎒🎒🎒🎒🎒🎒🎒🎒📙📙📙🌝🌝🌿🌿🚙🚙💜💜💜🚙🚙🌿🌿🌝🌝📙📙🎒🎒🎒🎒🎒🎒📙📙📙📙📙📙🌝📙📙📙📙📙📙🎒🎒🎒🎒🎒📙📙🌝🌝🌿🌿🚙
💜💜🚙🚙🌿🌿🌝🌝📙📙🎒🎒🎒🎒🎒🎒🎒🎒📙📙📙📙🎒🎒🎒🎒🎒🎒🎒🎒📙📙🌝🌝🌿🌿🚙🚙💜💜💜🚙🚙🌿🌿🌝🌝📙📙🎒🎒🎒🎒🎒📙📙📙📙📙🌝🌝🌝🌝📙📙📙📙📙🎒🎒🎒🎒🎒📙📙🌝🌝🌿🌿🚙
💜💜🚙🚙🌿🌝🌝📙📙📙🎒🎒🎒🎒🎒🎒🎒📙📙📙📙📙🎒🎒🎒🎒🎒🎒🎒🎒📙📙🌝🌝🌿🌿🚙🚙💜💜💜🚙🚙🌿🌿🌝🌝📙📙🎒🎒🎒🎒🎒📙📙📙📙📙🌝🌝🌝🌝🌝📙📙📙📙📙🎒🎒🎒🎒🎒📙📙🌝🌿🌿🚙
💜💜🚙🌿🌿🌝🌝📙📙🎒🎒🎒🎒🎒🎒🎒📙📙📙📙📙📙📙🎒🎒🎒🎒🎒🎒🎒📙📙🌝🌝🌿🌿🚙🚙💜💜💜🚙🚙🌿🌿🌝🌝📙📙🎒🎒🎒🎒🎒📙📙📙📙🌝🌝🌝🌝🌝🌝🌝📙📙📙📙🎒🎒🎒🎒🎒📙📙🌝🌝🌿🚙
💜🚙🚙🌿🌿🌝🌝📙📙🎒🎒🎒🎒🎒🎒📙📙📙📙📙📙📙📙📙🎒🎒🎒🎒🎒🎒📙📙🌝🌝🌿🌿🚙🚙💜💜💜🚙🚙🌿🌿🌝🌝📙📙🎒🎒🎒🎒🎒📙📙📙🌝🌝🌝🌝🌝🌝🌝🌝🌝📙📙📙📙🎒🎒🎒🎒📙📙🌝🌝🌿🌿
💜🚙🚙🌿🌝🌝📙📙🎒🎒🎒🎒🎒🎒📙📙📙📙📙📙📙📙📙📙🎒🎒🎒🎒🎒🎒📙📙🌝🌝🌿🌿🚙🚙💜💜💜🚙🚙🌿🌿🌝🌝📙📙🎒🎒🎒🎒📙📙📙📙🌝🌝🌝🌝🌝🌝🌝🌝🌝🌝📙📙📙🎒🎒🎒🎒🎒📙📙🌝🌿🌿
💜🚙🌿🌿🌝🌝📙📙🎒🎒🎒🎒🎒📙📙📙📙📙📙📙📙📙📙📙📙🎒🎒🎒🎒🎒📙📙🌝🌝🌿🌿🚙🚙💜💜💜🚙🚙🌿🌿🌝🌝📙📙🎒🎒🎒🎒📙📙📙🌝🌝🌝🌝🌝🌝🌝🌝🌝🌝🌝🌝📙📙📙🎒🎒🎒🎒📙📙🌝🌝🌿
🚙🚙🌿🌿🌝📙📙🎒🎒🎒🎒🎒📙📙📙📙📙📙📙📙📙📙📙📙📙🎒🎒🎒🎒🎒🎒📙📙🌝🌝🌿🚙🚙💜💜💜🚙🚙🌿🌿🌝📙📙🎒🎒🎒🎒🎒📙📙📙🌝🌝🌝🌝🌝🌝🌝🌝🌝🌝🌝🌝🌝📙📙🎒🎒🎒🎒🎒📙🌝🌝🌿
🚙🌿🌿🌝🌝📙📙🎒🎒🎒🎒🎒📙📙📙📙🌝🌝🌝🌝🌝📙📙📙📙📙🎒🎒🎒🎒🎒📙📙🌝🌝🌿🚙🚙💜💜💜🚙🚙🌿🌿🌝📙📙🎒🎒🎒🎒📙📙📙🌝🌝🌝🌝🌝🌿🌿🌿🌿🌿🌝🌝🌝🌝📙📙📙🎒🎒🎒🎒📙📙🌝🌝
🚙🌿🌿🌝📙📙🎒🎒🎒🎒🎒📙📙📙📙🌝🌝🌝🌝🌝🌝🌝📙📙📙📙🎒🎒🎒🎒🎒📙📙🌝🌝🌿🚙🚙💜💜💜🚙🚙🌿🌿🌝📙📙🎒🎒🎒🎒📙📙📙🌝🌝🌝🌝🌿🌿🌿🌿🌿🌿🌿🌝🌝🌝🌝📙📙📙🎒🎒🎒🎒📙🌝🌝
🌿🌿🌝🌝📙📙🎒🎒🎒🎒📙📙📙🌝🌝🌝🌝🌝🌝🌝🌝🌝🌝📙📙📙📙🎒🎒🎒🎒📙📙🌝🌝🌿🌿🚙💜💜💜🚙🚙🌿🌝🌝📙📙🎒🎒🎒🎒📙📙🌝🌝🌝🌝🌿🌿🌿🌿🌿🌿🌿🌿🌿🌿🌝🌝🌝📙📙🎒🎒🎒🎒📙📙🌝
🌿🌝🌝📙📙🎒🎒🎒🎒📙📙📙🌝🌝🌝🌝🌝🌝🌝🌝🌝🌝🌝🌝📙📙📙🎒🎒🎒🎒📙📙🌝🌝🌿🌿🚙💜💜💜🚙🚙🌿🌝🌝📙📙🎒🎒🎒🎒📙📙🌝🌝🌝🌿🌿🌿🌿🌿🌿🌿🌿🌿🌿🌿🌿🌝🌝🌝📙📙🎒🎒🎒🎒📙📙
🌿🌝📙📙🎒🎒🎒🎒📙📙📙🌝🌝🌝🌝🌝🌿🌿🌿🌿🌝🌝🌝🌝🌝📙📙🎒🎒🎒🎒🎒📙🌝🌝🌿🌿🚙💜💜💜🚙🚙🌿🌝🌝📙📙🎒🎒🎒📙📙📙🌝🌝🌿🌿🌿🌿🌿🚙🚙🚙🚙🌿🌿🌿🌿🌿🌝🌝🌝📙📙🎒🎒🎒🎒📙
🌝🌝📙🎒🎒🎒🎒🎒📙📙🌝🌝🌝🌝🌿🌿🌿🌿🌿🌿🌿🌝🌝🌝🌝📙📙📙🎒🎒🎒🎒📙📙🌝🌿🌿🚙💜💜💜🚙🚙🌿🌝🌝📙🎒🎒🎒🎒📙📙🌝🌝🌝🌿🌿🌿🌿🚙🚙🚙🚙🚙🚙🚙🌿🌿🌿🌿🌝🌝📙📙📙🎒🎒🎒📙
🌝📙📙🎒🎒🎒🎒📙📙🌝🌝🌝🌿🌿🌿🌿🌿🌿🌿🌿🌿🌿🌿🌝🌝🌝📙📙🎒🎒🎒🎒📙📙🌝🌿🌿🚙💜💜💜🚙🚙🌿🌝🌝📙🎒🎒🎒🎒📙📙🌝🌝🌿🌿🌿🚙🚙🚙🚙🚙🚙🚙🚙🚙🚙🚙🌿🌿🌿🌝🌝📙📙🎒🎒🎒🎒
📙📙🎒🎒🎒🎒📙📙🌝🌝🌝🌿🌿🌿🌿🌿🌿🌿🌿🌿🌿🌿🌿🌝🌝🌝📙📙📙🎒🎒🎒📙📙🌝🌿🌿🚙💜💜💜🚙🚙🌿🌝🌝📙🎒🎒🎒🎒📙🌝🌝🌝🌿🌿🌿🚙🚙🚙🚙🚙🚙🚙🚙🚙🚙🚙🚙🌿🌿🌿🌝🌝📙📙🎒🎒🎒
📙🎒🎒🎒🎒📙📙🌝🌝🌝🌿🌿🌿🌿🚙🚙🚙🚙🚙🚙🌿🌿🌿🌿🌝🌝🌝📙📙🎒🎒🎒📙📙🌝🌿🌿🚙💜💜💜🚙🚙🌿🌝🌝📙🎒🎒🎒📙📙🌝🌝🌿🌿🌿🚙🚙🚙🚙💜💜💜💜💜💜🚙🚙🚙🚙🌿🌿🌿🌝🌝📙📙🎒🎒
🎒🎒🎒🎒📙📙🌝🌝🌝🌿🌿🌿🚙🚙🚙🚙🚙🚙🚙🚙🚙🌿🌿🌿🌿🌝🌝📙📙🎒🎒🎒🎒📙🌝🌝🌿🚙💜💜💜🚙🚙🌿🌝📙📙🎒🎒🎒📙📙🌝🌝🌿🌿🚙🚙🚙🚙💜💜💜💜💜💜💜💜💜🚙🚙🚙🌿🌿🌿🌝🌝📙📙🎒
🎒🎒🎒📙📙🌝🌝🌝🌿🌿🌿🚙🚙🚙🚙🚙🚙🚙🚙🚙🚙🚙🌿🌿🌿🌝🌝📙📙🎒🎒🎒🎒📙🌝🌝🌿🚙💜💜💜🚙🚙🌿🌝📙📙🎒🎒🎒📙📙🌝🌝🌿🌿🚙🚙🚙💜💜💜💜💜💜💜💜💜💜💜🚙🚙🚙🌿🌿🌿🌝🌝📙📙
🎒🎒📙📙🌝🌝🌝🌿🌿🚙🚙🚙🚙🚙💜💜💜💜🚙🚙🚙🚙🚙🌿🌿🌿🌝🌝📙📙🎒🎒🎒📙🌝🌝🌿🚙💜💜💜🚙🚙🌿🌝📙📙🎒🎒🎒📙🌝🌝🌿🌿🚙🚙🚙💜💜💜💜💜💜💜💜💜💜💜💜💜💜🚙🚙🌿🌿🌿🌝🌝📙
🎒📙📙🌝🌝🌝🌿🌿🚙🚙🚙🚙💜💜💜💜💜💜💜💜🚙🚙🚙🚙🌿🌿🌝🌝📙📙🎒🎒🎒📙🌝🌝🌿🚙🚙💜💜🚙🌿🌿🌝📙📙🎒🎒📙📙🌝🌝🌿🌿🚙🚙💜💜💜💜💜💜💜💜💜💜💜💜💜💜💜💜🚙🚙🌿🌿🌿🌝🌝
📙📙🌝🌝🌝🌿🌿🚙🚙🚙💜💜💜💜💜💜💜💜💜💜💜🚙🚙🚙🌿🌿🌝🌝📙📙🎒🎒🎒📙📙🌝🌿🚙🚙💜💜🚙🌿🌿🌝📙🎒🎒🎒📙📙🌝🌝🌿🌿🚙🚙💜💜💜💜💜💜💜💜💜💜💜💜💜💜💜💜💜🚙🚙🌿🌿🌿🌝
📙🌝🌝🌝🌿🌿🚙🚙🚙💜💜💜💜💜💜💜💜💜💜💜💜💜🚙🚙🚙🌿🌿🌝🌝📙🎒🎒🎒📙📙🌝🌿🚙🚙💜💜🚙🌿🌿🌝📙🎒🎒🎒📙📙🌝🌿🌿🚙🚙💜💜💜💜💜💜💜💜💜🚙💜💜💜💜💜💜💜💜💜🚙🚙🌿🌿🌿
🌝🌝🌝🌿🌿🚙🚙🚙💜💜💜💜💜💜💜💜💜💜💜💜💜💜💜🚙🚙🌿🌿🌝🌝📙🎒🎒🎒📙📙🌝🌿🚙🚙💜💜🚙🌿🌿🌝📙🎒🎒🎒📙📙🌝🌿🌿🚙🚙💜💜💜💜💜💜🚙🚙🚙🚙🚙🚙🚙💜💜💜💜💜💜💜🚙🚙🌿🌿
🌝🌿🌿🌿🚙🚙💜💜💜💜💜💜💜💜💜💜💜💜💜💜💜💜💜🚙🚙🌿🌿🌝🌝📙📙🎒🎒📙📙🌝🌿🚙🚙💜💜🚙🌿🌿🌝📙🎒🎒🎒📙🌝🌝🌿🌿🚙🚙💜💜💜💜💜🚙🚙🚙🚙🚙🚙🚙🚙🚙🚙💜💜💜💜💜💜🚙🚙🚙
🌿🌿🌿🚙🚙💜💜💜💜💜💜💜💜💜💜💜💜💜💜💜💜💜💜💜🚙🚙🌿🌿🌝📙📙🎒🎒🎒📙🌝🌿🚙🚙💜💜🚙🌿🌿🌝📙🎒🎒🎒📙🌝🌝🌿🚙🚙💜💜💜💜💜🚙🚙🚙🚙🚙🚙🚙🚙🚙🚙🚙🚙💜💜💜💜💜💜🚙🚙
🌿🌿🚙🚙💜💜💜💜💜💜💜💜🚙🚙🚙🚙🚙💜💜💜💜💜💜💜🚙🚙🌿🌿🌝📙📙🎒🎒🎒📙🌝🌿🚙🚙💜💜🚙🌿🌿🌝📙🎒🎒🎒📙🌝🌝🌿🚙🚙💜💜💜💜💜🚙🚙🚙🚙🌿🌿🌿🌿🌿🚙🚙🚙🚙🚙💜💜💜💜💜🚙
🌿🚙🚙💜💜💜💜💜💜💜🚙🚙🚙🚙🚙🚙🚙🚙💜💜💜💜💜💜🚙🚙🌿🌿🌝🌝📙🎒🎒🎒📙🌝🌿🚙🚙💜💜🚙🌿🌿🌝📙🎒🎒🎒📙🌝🌿🌿🚙🚙💜💜💜💜🚙🚙🚙🚙🌿🌿🌿🌿🌿🌿🌿🌿🚙🚙🚙🚙💜💜💜💜💜
🚙🚙💜💜💜💜💜💜💜🚙🚙🚙🚙🚙🚙🚙🚙🚙🚙💜💜💜💜💜🚙🚙🌿🌿🌝🌝📙🎒🎒🎒📙🌝🌿🌿🚙💜💜🚙🌿🌝🌝📙🎒🎒🎒📙🌝🌿🌿🚙🚙💜💜💜💜🚙🚙🚙🌿🌿🌿🌿🌿🌿🌿🌿🌿🌿🚙🚙🚙🚙💜💜💜💜
🚙💜💜💜💜💜💜💜🚙🚙🚙🚙🚙🚙🚙🚙🚙🚙🚙🚙💜💜💜💜💜🚙🚙🌿🌝🌝📙🎒🎒🎒📙🌝🌿🌿🚙💜💜🚙🌿🌝🌝📙🎒🎒📙📙🌝🌿🌿🚙💜💜💜💜💜🚙🚙🌿🌿🌿🌿🌿🌿🌿🌿🌿🌿🌿🌿🚙🚙🚙🚙💜💜💜
💜💜💜💜💜💜💜🚙🚙🚙🚙🚙🚙🚙🚙🚙🚙🚙🚙🚙💜💜💜💜💜🚙🚙🌿🌝🌝📙🎒🎒🎒📙🌝🌿🌿🚙💜💜🚙🌿🌝🌝📙🎒🎒📙📙🌝🌿🌿🚙💜💜💜💜🚙🚙🚙🌿🌿🌿🌿🌿🌿🌿🌿🌿🌿🌿🌿🌿🚙🚙🚙🚙💜💜
💜💜💜💜💜💜🚙🚙🚙🚙🚙🌿🌿🌿🌿🌿🚙🚙🚙🚙💜💜💜💜💜🚙🚙🌿🌝🌝📙🎒🎒🎒📙🌝🌿🌿🚙💜💜🚙🌿🌝🌝📙🎒🎒📙📙🌝🌿🌿🚙💜💜💜💜🚙🚙🚙🌿🌿🌿🌿🌝🌝🌝🌝🌝🌿🌿🌿🌿🌿🚙🚙🚙🚙💜
💜💜💜💜💜🚙🚙🚙🚙🌿🌿🌿🌿🌿🌿🌿🌿🚙🚙🚙🚙💜💜💜💜🚙🚙🌿🌝🌝📙🎒🎒🎒📙🌝🌿🌿🚙💜💜🚙🌿🌝🌝📙🎒🎒📙📙🌝🌿🌿🚙💜💜💜💜🚙🚙🌿🌿🌿🌿🌝🌝🌝🌝🌝🌝🌝🌝🌿🌿🌿🌿🚙🚙🚙🚙
💜💜💜💜🚙🚙🚙🚙🌿🌿🌿🌿🌿🌿🌿🌿🌿🚙🚙🚙🚙💜💜💜💜🚙🚙🌿🌝🌝📙🎒🎒🎒📙🌝🌿🌿🚙💜💜🚙🌿🌝🌝📙🎒🎒📙📙🌝🌿🌿🚙💜💜💜💜🚙🚙🌿🌿🌿🌿🌝🌝🌝🌝🌝🌝🌝🌝🌝🌿🌿🌿🌿🚙🚙🚙
💜💜💜🚙🚙🚙🚙🌿🌿🌿🌿🌿🌿🌿🌿🌿🌿🚙🚙🚙🚙💜💜💜💜🚙🚙🌿🌝🌝📙🎒🎒🎒📙🌝🌿🌿🚙💜💜🚙🌿🌝🌝📙🎒🎒📙📙🌝🌿🌿🚙💜💜💜💜🚙🚙🌿🌿🌿🌿🌝🌝🌝🌝🌝🌝🌝🌝🌝🌝🌿🌿🌿🌿🚙🚙
💜💜🚙🚙🚙🚙🌿🌿🌿🌿🌿🌿🌿🌿🌿🌿🌿🚙🚙🚙🚙💜💜💜💜🚙🚙🌿🌝🌝📙🎒🎒🎒📙🌝🌿🌿🚙💜💜🚙🌿🌝🌝📙🎒🎒📙📙🌝🌿🌿🚙💜💜💜💜🚙🚙🌿🌿🌿🌿🌝🌝🌝🌝🌝🌝🌝🌝🌝🌝🌝🌿🌿🌿🌿🚙
💜💜🚙🚙🚙🚙🌿🌿🌿🌿🌿🌿🌿🌿🌿🌿🌿🚙🚙🚙🚙💜💜💜💜🚙🚙🌿🌝🌝📙🎒🎒🎒📙🌝🌿🌿🚙💜💜🚙🌿🌝🌝📙🎒🎒📙📙🌝🌿🌿🚙💜💜💜💜🚙🚙🌿🌿🌿🌿🌝🌝🌝🌝🌝🌝🌝🌝🌝🌝🌝🌿🌿🌿🌿🚙
💜🚙🚙🚙🚙🌿🌿🌿🌿🌿🌿🌿🌿🌿🌿🌿🌿🚙🚙🚙🚙💜💜💜💜🚙🚙🌿🌝🌝📙🎒🎒🎒📙🌝🌿🌿🚙💜💜🚙🌿🌝🌝📙🎒🎒📙📙🌝🌿🌿🚙💜💜💜💜🚙🚙🌿🌿🌿🌿🌝🌝🌝🌝🌝🌝🌝🌝🌝🌝🌝🌝🌿🌿🌿🌿
💜🚙🚙🚙🚙🌿🌿🌿🌿🌿🌿🌿🌿🌿🌿🌿🌿🚙🚙🚙💜💜💜💜💜🚙🚙🌿🌝🌝📙🎒🎒🎒📙🌝🌿🌿🚙💜💜🚙🌿🌝🌝📙🎒🎒📙📙🌝🌿🌿🚙💜💜💜💜🚙🚙🚙🌿🌿🌿🌝🌝🌝🌝🌝🌝🌝🌝🌝🌝🌝🌝🌿🌿🌿🌿
🚙🚙🚙🚙🚙🌿🌿🌿🌿🌿🌿🌿🌿🌿🌿🌿🌿🚙🚙🚙💜💜💜💜💜🚙🚙🌿🌝🌝📙🎒🎒🎒📙🌝🌿🚙🚙💜💜🚙🌿🌿🌝📙🎒🎒🎒📙🌝🌿🌿🚙💜💜💜💜🚙🚙🚙🌿🌿🌿🌝🌝🌝🌝🌝🌝🌝🌝🌝🌝🌝🌝🌿🌿🌿🌿
🚙🚙🚙🚙🚙🌿🌿🌿🌿🌿🌿🌿🌿🌿🌿🌿🚙🚙🚙🚙💜💜💜💜💜🚙🌿🌿🌝🌝📙🎒🎒🎒📙🌝🌿🚙🚙💜💜🚙🌿🌿🌝📙🎒🎒🎒📙🌝🌿🌿🚙🚙💜💜💜💜🚙🚙🌿🌿🌿🌿🌝🌝🌝🌝🌝🌝🌝🌝🌝🌝🌝🌿🌿🌿🌿
🚙🚙🚙🚙🚙🌿🌿🌿🌿🌿🌿🌿🌿🌿🌿🌿🚙🚙🚙🚙💜💜💜💜🚙🚙🌿🌿🌝📙📙🎒🎒🎒📙🌝🌿🚙🚙💜💜🚙🌿🌿🌝📙🎒🎒🎒📙🌝🌝🌿🚙🚙💜💜💜💜🚙🚙🌿🌿🌿🌿🌝🌝🌝🌝🌝🌝🌝🌝🌝🌝🌝🌿🌿🌿🌿
🚙🚙🚙🚙🚙🚙🌿🌿🌿🌿🌿🌿🌿🌿🌿🚙🚙🚙🚙💜💜💜💜💜🚙🚙🌿🌿🌝📙📙🎒🎒📙📙🌝🌿🚙🚙💜💜🚙🌿🌿🌝📙🎒🎒🎒📙🌝🌝🌿🚙🚙💜💜💜💜🚙🚙🚙🌿🌿🌿🌿🌝🌝🌝🌝🌝🌝🌝🌝🌝🌿🌿🌿🌿🌿
🚙🚙🚙🚙🚙🚙🚙🌿🌿🌿🌿🌿🌿🚙🚙🚙🚙🚙💜💜💜💜💜💜🚙🚙🌿🌝🌝📙🎒🎒🎒📙📙🌝🌿🚙🚙💜💜🚙🌿🌿🌝📙🎒🎒🎒📙📙🌝🌿🌿🚙💜💜💜💜💜🚙🚙🚙🌿🌿🌿🌿🌿🌝🌝🌝🌝🌝🌝🌿🌿🌿🌿🌿🌿
🚙🚙🚙🚙🚙🚙🚙🚙🚙🚙🚙🚙🚙🚙🚙🚙🚙🚙💜💜💜💜💜🚙🚙🌿🌿🌝🌝📙🎒🎒🎒📙📙🌝🌿🚙🚙💜💜🚙🌿🌿🌝📙🎒🎒🎒📙📙🌝🌿🌿🚙🚙💜💜💜💜🚙🚙🚙🌿🌿🌿🌿🌿🌿🌿🌿🌿🌿🌿🌿🌿🌿🌿🌿🌿
💜🚙🚙🚙🚙🚙🚙🚙🚙🚙🚙🚙🚙🚙🚙🚙🚙💜💜💜💜💜💜🚙🚙🌿🌿🌝📙📙🎒🎒🎒📙🌝🌝🌿🚙🚙💜💜🚙🌿🌿🌝📙📙🎒🎒📙📙🌝🌝🌿🚙🚙💜💜💜💜💜🚙🚙🚙🌿🌿🌿🌿🌿🌿🌿🌿🌿🌿🌿🌿🌿🌿🌿🌿
💜💜💜🚙🚙🚙🚙🚙🚙🚙🚙🚙🚙🚙🚙💜💜💜💜💜💜💜🚙🚙🌿🌿🌝🌝📙📙🎒🎒🎒📙🌝🌝🌿🚙💜💜💜🚙🚙🌿🌝📙📙🎒🎒🎒📙🌝🌝🌿🌿🚙🚙💜💜💜💜💜🚙🚙🚙🚙🌿🌿🌿🌿🌿🌿🌿🌿🌿🌿🌿🌿🚙🚙
💜💜💜💜💜🚙🚙🚙🚙🚙🚙🚙🚙💜💜💜💜💜💜💜💜🚙🚙🚙🌿🌿🌝🌝📙🎒🎒🎒🎒📙🌝🌝🌿🚙💜💜💜🚙🚙🌿🌝📙📙🎒🎒🎒📙📙🌝🌿🌿🚙🚙💜💜💜💜💜💜🚙🚙🚙🚙🚙🌿🌿🌿🌿🌿🌿🌿🌿🚙🚙🚙🚙
💜💜💜💜💜💜💜💜💜💜💜💜💜💜💜💜💜💜💜💜🚙🚙🚙🌿🌿🌝🌝📙📙🎒🎒🎒📙📙🌝🌿🌿🚙💜💜💜🚙🚙🌿🌝🌝📙🎒🎒🎒📙📙🌝🌝🌿🌿🚙🚙💜💜💜💜💜💜🚙🚙🚙🚙🚙🚙🚙🚙🚙🚙🚙🚙🚙🚙🚙🚙
💜💜💜💜💜💜💜💜💜💜💜💜💜💜💜💜💜💜💜🚙🚙🚙🌿🌿🌿🌝🌝📙📙🎒🎒🎒📙📙🌝🌿🌿🚙💜💜💜🚙🚙🌿🌝🌝📙🎒🎒🎒🎒📙🌝🌝🌿🌿🚙🚙🚙💜💜💜💜💜💜💜🚙🚙🚙🚙🚙🚙🚙🚙🚙🚙🚙🚙🚙🚙
💜💜💜💜💜💜💜💜💜💜💜💜💜💜💜💜💜💜🚙🚙🚙🌿🌿🌿🌝🌝📙📙🎒🎒🎒🎒📙🌝🌝🌿🌿🚙💜💜💜🚙🚙🌿🌝🌝📙📙🎒🎒🎒📙📙🌝🌝🌿🌿🚙🚙🚙💜💜💜💜💜💜💜💜🚙🚙🚙🚙🚙🚙🚙🚙🚙🚙💜💜
💜💜💜💜💜💜💜💜💜💜💜💜💜💜💜💜🚙🚙🚙🚙🌿🌿🌿🌝🌝🌝📙📙🎒🎒🎒📙📙🌝🌝🌿🌿🚙💜💜💜🚙🚙🌿🌝🌝📙📙🎒🎒🎒📙📙🌝🌝🌿🌿🌿🚙🚙🚙💜💜💜💜💜💜💜💜💜💜💜💜💜💜💜💜💜💜💜
💜💜💜💜💜💜💜💜💜💜💜💜💜💜🚙🚙🚙🚙🚙🌿🌿🌿🌝🌝🌝📙📙🎒🎒🎒🎒📙📙🌝🌝🌿🚙🚙💜💜💜🚙🚙🌿🌿🌝📙📙🎒🎒🎒🎒📙📙🌝🌝🌿🌿🌿🚙🚙🚙💜💜💜💜💜💜💜💜💜💜💜💜💜💜💜💜💜💜
🚙🚙🚙🚙🚙🚙🚙🚙🚙🚙🚙🚙🚙🚙🚙🚙🚙🌿🌿🌿🌿🌝🌝🌝📙📙🎒🎒🎒🎒🎒📙📙🌝🌿🌿🚙🚙💜💜💜🚙🚙🌿🌿🌝🌝📙🎒🎒🎒🎒📙📙📙🌝🌝🌿🌿🌿🚙🚙🚙🚙💜💜💜💜💜💜💜💜💜💜💜💜💜💜💜💜
🚙🚙🚙🚙🚙🚙🚙🚙🚙🚙🚙🚙🚙🚙🚙🌿🌿🌿🌿🌿🌝🌝🌝📙📙📙🎒🎒🎒🎒📙📙🌝🌝🌿🌿🚙🚙💜💜💜🚙🚙🌿🌿🌝🌝📙📙🎒🎒🎒🎒📙📙🌝🌝🌝🌿🌿🌿🚙🚙🚙🚙🚙💜💜💜💜💜💜💜💜💜💜💜💜💜💜
🌿🌿🌿🌿🚙🚙🚙🚙🚙🚙🌿🌿🌿🌿🌿🌿🌿🌿🌝🌝🌝🌝📙📙📙🎒🎒🎒🎒🎒📙📙🌝🌝🌿🌿🚙🚙💜💜💜🚙🚙🌿🌿🌝🌝📙📙🎒🎒🎒🎒🎒📙📙🌝🌝🌝🌿🌿🌿🌿🚙🚙🚙🚙🚙🚙🚙🚙💜💜💜💜💜💜🚙🚙🚙
🌿🌿🌿🌿🌿🌿🌿🌿🌿🌿🌿🌿🌿🌿🌿🌝🌝🌝🌝🌝📙📙📙🎒🎒🎒🎒🎒🎒📙📙🌝🌝🌿🌿🚙🚙💜💜💜💜🚙🚙🚙🌿🌿🌝🌝📙📙🎒🎒🎒🎒🎒📙📙📙🌝🌝🌝🌿🌿🌿🌿🌿🚙🚙🚙🚙🚙🚙🚙🚙🚙🚙🚙🚙🚙🚙
🌝🌝🌝🌿🌿🌿🌿🌿🌿🌝🌝🌝🌝🌝🌝🌝🌝🌝📙📙📙📙🎒🎒🎒🎒🎒🎒📙📙📙🌝🌝🌿🌿🚙🚙💜💜💜💜💜🚙🚙🌿🌿🌝🌝📙📙🎒🎒🎒🎒🎒🎒📙📙📙🌝🌝🌝🌝🌿🌿🌿🌿🌿🌿🌿🌿🌿🚙🚙🚙🚙🚙🚙🌿🌿
🌝🌝🌝🌝🌝🌝🌝🌝🌝🌝🌝🌝🌝🌝🌝📙📙📙📙📙🎒🎒🎒🎒🎒🎒🎒📙📙📙🌝🌝🌿🌿🌿🚙🚙💜💜💜💜💜🚙🚙🌿🌿🌝🌝🌝📙📙🎒🎒🎒🎒🎒🎒📙📙📙📙🌝🌝🌝🌝🌝🌿🌿🌿🌿🌿🌿🌿🌿🌿🌿🌿🌿🌿🌿
📙📙📙📙📙📙📙📙📙📙📙📙📙📙📙📙📙📙🎒🎒🎒🎒🎒🎒🎒🎒📙📙📙🌝🌝🌝🌿🌿🚙🚙🚙💜💜💜💜💜🚙🚙🌿🌿🌿🌝🌝📙📙📙🎒🎒🎒🎒🎒🎒🎒📙📙📙📙🌝🌝🌝🌝🌝🌝🌝🌝🌝🌝🌝🌝🌝🌝🌝🌝🌝
📙📙📙📙📙📙📙📙📙📙📙📙📙📙🎒🎒🎒🎒🎒🎒🎒🎒🎒🎒🎒📙📙📙🌝🌝🌝🌿🌿🌿🚙🚙🚙💜💜💜💜💜🚙🚙🌿🌿🌿🌝🌝🌝📙📙📙🎒🎒🎒🎒🎒🎒🎒🎒📙📙📙📙📙📙🌝🌝🌝🌝🌝🌝🌝🌝🌝🌝🌝🌝🌝
🎒🎒🎒🎒🎒🎒🎒🎒🎒🎒🎒🎒🎒🎒🎒🎒🎒🎒🎒🎒🎒🎒🎒📙📙📙📙🌝🌝🌝🌿🌿🌿🚙🚙🚙💜💜💜💜💜💜🚙🚙🚙🌿🌿🌿🌝🌝🌝📙📙📙🎒🎒🎒🎒🎒🎒🎒🎒🎒📙📙📙📙📙📙📙📙📙📙📙📙📙📙📙📙📙
🎒🎒🎒🎒🎒🎒🎒🎒🎒🎒🎒🎒🎒🎒🎒🎒🎒🎒🎒🎒📙📙📙📙📙🌝🌝🌝🌝🌿🌿🌿🌿🚙🚙🚙💜💜💜💜💜💜🚙🚙🚙🌿🌿🌿🌝🌝🌝🌝📙📙📙📙🎒🎒🎒🎒🎒🎒🎒🎒🎒🎒🎒🎒📙📙📙📙📙📙📙📙📙📙📙📙
🎒🎒🎒🎒🎒🎒🎒🎒🎒🎒🎒🎒🎒🎒🎒🎒🎒📙📙📙📙📙📙🌝🌝🌝🌝🌝🌿🌿🌿🌿🚙🚙🚙💜💜💜💜💜💜💜🚙🚙🚙🚙🌿🌿🌿🌝🌝🌝🌝📙📙📙📙📙🎒🎒🎒🎒🎒🎒🎒🎒🎒🎒🎒🎒🎒🎒🎒🎒🎒🎒🎒🎒🎒🎒
🎒🎒🎒🎒🎒🎒🎒🎒🎒📙📙📙📙📙📙📙📙📙📙📙🌝🌝🌝🌝🌝🌝🌿🌿🌿🌿🌿🚙🚙🚙🚙💜💜💜💜💜💜💜🚙🚙🚙🚙🌿🌿🌿🌿🌝🌝🌝🌝🌝📙📙📙📙📙📙🎒🎒🎒🎒🎒🎒🎒🎒🎒🎒🎒🎒🎒🎒🎒🎒🎒🎒🎒
📙📙📙📙📙📙📙📙📙📙📙📙📙📙📙📙🌝🌝🌝🌝🌝🌝🌝🌝🌿🌿🌿🌿🌿🚙🚙🚙🚙🚙💜💜💜💜💜💜💜💜💜🚙🚙🚙🚙🌿🌿🌿🌿🌿🌝🌝🌝🌝🌝📙📙📙📙📙📙📙📙🎒🎒🎒🎒🎒🎒🎒🎒🎒🎒🎒🎒🎒🎒🎒
🌝🌝🌝🌝🌝🌝🌝🌝🌝🌝🌝🌝🌝🌝🌝🌝🌝🌝🌝🌝🌿🌿🌿🌿🌿🌿🌿🌿🚙🚙🚙🚙🚙💜💜💜💜💜💜💜💜💜💜🚙🚙🚙🚙🚙🌿🌿🌿🌿🌿🌝🌝🌝🌝🌝🌝🌝🌝📙📙📙📙📙📙📙📙📙📙📙📙📙📙📙📙📙📙📙
🌝🌝🌝🌝🌝🌝🌝🌝🌝🌝🌝🌝🌝🌝🌿🌿🌿🌿🌿🌿🌿🌿🌿🌿🌿🚙🚙🚙🚙🚙🚙🚙💜💜💜💜💜💜💜💜💜💜💜🚙🚙🚙🚙🚙🚙🌿🌿🌿🌿🌿🌿🌿🌝🌝🌝🌝🌝🌝🌝🌝🌝🌝🌝📙📙📙📙📙📙📙📙📙📙📙📙📙
🌿🌿🌿🌿🌿🌿🌿🌿🌿🌿🌿🌿🌿🌿🌿🌿🌿🌿🌿🌿🚙🚙🚙🚙🚙🚙🚙🚙🚙🚙💜💜💜💜💜💜💜💜💜💜💜💜💜💜🚙🚙🚙🚙🚙🚙🚙🌿🌿🌿🌿🌿🌿🌿🌿🌿🌿🌝🌝🌝🌝🌝🌝🌝🌝🌝🌝🌝🌝🌝🌝🌝🌝🌝🌝🌝
🚙🚙🚙🚙🚙🚙🚙🚙🚙🚙🚙🚙🚙🚙🚙🚙🚙🚙🚙🚙🚙🚙🚙🚙🚙🚙🚙💜💜💜💜💜💜💜💜💜💜💜💜💜💜💜💜💜💜🚙🚙🚙🚙🚙🚙🚙🚙🚙🌿🌿🌿🌿🌿🌿🌿🌿🌿🌿🌿🌿🌿🌿🌿🌿🌿🌿🌿🌿🌿🌿🌿🌿🌿🌿
🚙🚙🚙🚙🚙🚙🚙🚙🚙🚙🚙🚙🚙🚙🚙🚙🚙🚙🚙🚙💜💜💜💜💜💜💜💜💜💜💜💜💜💜💜💜💜💜💜💜💜💜💜💜💜💜🚙🚙🚙🚙🚙🚙🚙🚙🚙🚙🚙🚙🚙🚙🚙🌿🌿🌿🌿🌿🌿🌿🌿🌿🌿🌿🌿🌿🌿🌿🌿🌿🌿🌿
💜💜💜💜💜💜💜💜💜💜💜💜💜💜💜💜💜💜💜💜💜💜💜💜💜💜💜💜💜💜💜💜💜💜💜💜💜💜💜💜💜💜💜💜💜💜💜💜💜🚙🚙🚙🚙🚙🚙🚙🚙🚙🚙🚙🚙🚙🚙🚙🚙🚙🚙🚙🚙🚙🚙🚙🚙🚙🚙🚙🚙🚙🚙🚙
💜💜💜💜💜💜💜💜💜💜💜💜💜💜💜💜💜💜💜💜💜💜💜💜💜💜💜💜💜💜💜💜💜💜💜💜💜💜💜💜💜💜💜💜💜💜💜💜💜💜💜💜💜💜💜💜💜💜💜💜💜🚙🚙🚙🚙🚙🚙🚙🚙🚙🚙🚙🚙🚙🚙🚙🚙🚙🚙🚙
