💜💜💜💜💜💜💜💜💜💜💜💜💜🚙🚙🚙🚙🚙🚙🚙🚙🚙🚙🚙🌿🌿🌿🌿🌿🌿🌿🌿🌿🌿🌿🌿🌿🌿🌿🌿🚙🚙🚙🚙🚙🚙🚙🚙🚙🚙🚙🚙🚙💜💜💜💜💜💜💜💜💜💜💜💜💜💜💜💜💜💜💜💜💜💜💜💜💜💜💜
💜💜💜💜💜💜💜💜💜💜💜💜💜🚙🚙🚙🚙🚙🚙🚙🚙🚙🚙🚙🌿🌿🌿🌿🌿🌿🌿🌿🌿🌿🌿🌿🌿🌿🌿🌿🌿🌿🚙🚙🚙🚙🚙🚙🚙🚙🚙🚙🚙🚙💜💜💜💜💜💜💜💜💜💜💜💜💜💜💜💜💜💜💜💜💜💜💜💜💜💜
💜💜💜💜💜💜💜💜💜💜💜💜💜🚙🚙🚙🚙🚙🚙🚙🚙🚙🚙🚙🌿🌿🌿🌿🌿🌿🌿🌿🌿🌿🌿🌿🌿🌿🌿🌿🌿🌿🌿🚙🚙🚙🚙🚙🚙🚙🚙🚙🚙🚙🚙💜💜💜💜💜💜💜💜💜💜💜💜💜💜💜💜💜💜💜💜💜💜💜💜💜
💜💜💜💜💜💜💜💜💜💜💜💜💜🚙🚙🚙🚙🚙🚙🚙🚙🚙🚙🌿🌿🌿🌿🌿🌿🌿🌿🌿🌿🌿🌿🌿🌿🌿🌿🌿🌿🌿🌿🌿🚙🚙🚙🚙🚙🚙🚙🚙🚙🚙🚙🚙💜💜💜💜💜💜💜💜💜💜💜💜💜💜💜💜💜💜💜💜💜💜💜💜
💜💜💜💜💜💜💜💜💜💜💜💜💜🚙🚙🚙🚙🚙🚙🚙🚙🚙🚙🌿🌿🌿🌿🌿🌿🌿🌿🌿🌿🌿🌿🌿🌿🌿🌿🌿🌿🌿🌿🌿🌿🚙🚙🚙🚙🚙🚙🚙🚙🚙🚙🚙🚙💜💜💜💜💜💜💜💜💜💜💜💜💜💜💜💜💜💜💜💜💜💜💜
💜💜💜💜💜💜💜💜💜💜💜💜💜🚙🚙🚙🚙🚙🚙🚙🚙🚙🚙🌿🌿🌿🌿🌿🌿🌿🌿🌿🌿🌿🌿🌿🌿🌿🌿🌿🌿🌿🌿🌿🌿🌿🚙🚙🚙🚙🚙🚙🚙🚙🚙🚙🚙🚙💜💜💜💜💜💜💜💜💜💜💜💜💜💜💜💜💜💜💜💜💜💜
💜💜💜💜💜💜💜💜💜💜💜💜💜🚙🚙🚙🚙🚙🚙🚙🚙🚙🚙🌿🌿🌿🌿🌿🌿🌿🌿🌿🌿🌿🌿🌿🌿🌿🌿🌿🌿🌿🌿🌿🌿🌿🌿🚙🚙🚙🚙🚙🚙🚙🚙🚙🚙🚙🚙💜💜💜💜💜💜💜💜💜💜💜💜💜💜💜💜💜💜💜💜💜
💜💜💜💜💜💜💜💜💜💜💜💜💜🚙🚙🚙🚙🚙🚙🚙🚙🚙🚙🌿🌿🌿🌿🌿🌿🌿🌿🌿🌿🌿🌿🌿🌿🌿🌿🌿🌿🌿🌿🌿🌿🌿🌿🌿🚙🚙🚙🚙🚙🚙🚙🚙🚙🚙🚙🚙🚙💜💜💜💜💜💜💜💜💜💜💜💜💜💜💜💜💜💜💜
💜💜💜💜💜💜💜💜💜💜💜💜💜🚙🚙🚙🚙🚙🚙🚙🚙🚙🚙🌿🌿🌿🌿🌿🌿🌿🌿🌿🌿🌿🌿🌿🌿🌿🌿🌿🌿🌿🌿🌿🌿🌿🌿🌿🌿🚙🚙🚙🚙🚙🚙🚙🚙🚙🚙🚙🚙🚙💜💜💜💜💜💜💜💜💜💜💜💜💜💜💜💜💜💜
💜💜💜💜💜💜💜💜💜💜💜💜💜💜🚙🚙🚙🚙🚙🚙🚙🚙🚙🚙🌿🌿🌿🌿🌿🌿🌿🌿🌿🌿🌿🌿🌿🌿🌿🌿🌿🌿🌿🌿🌿🌿🌿🌿🌿🌿🚙🚙🚙🚙🚙🚙🚙🚙🚙🚙🚙🚙🚙💜💜💜💜💜💜💜💜💜💜💜💜💜💜💜💜💜
💜💜💜💜💜💜💜💜💜💜💜💜💜💜🚙🚙🚙🚙🚙🚙🚙🚙🚙🚙🌿🌿🌿🌿🌿🌿🌿🌿🌿🌿🌿🌿🌿🌿🌿🌿🌿🌿🌿🌿🌿🌿🌿🌿🌿🌿🚙🚙🚙🚙🚙🚙🚙🚙🚙🚙🚙🚙🚙🚙🚙💜💜💜💜💜💜💜💜💜💜💜💜💜💜💜
💜💜💜💜💜💜💜💜💜💜💜💜💜💜🚙🚙🚙🚙🚙🚙🚙🚙🚙🚙🌿🌿🌿🌿🌿🌿🌿🌿🌿🌿🌿🌿🌿🌿🌿🌿🌿🌿🌿🌿🌿🌿🌿🌿🌿🌿🌿🚙🚙🚙🚙🚙🚙🚙🚙🚙🚙🚙🚙🚙🚙🚙💜💜💜💜💜💜💜💜💜💜💜💜💜💜
💜💜💜💜💜💜💜💜💜💜💜💜💜💜💜🚙🚙🚙🚙🚙🚙🚙🚙🚙🚙🌿🌿🌿🌿🌿🌿🌿🌿🌿🌿🌿🌿🌿🌿🌿🌿🌿🌿🌿🌿🌿🌿🌿🌿🌿🌿🌿🚙🚙🚙🚙🚙🚙🚙🚙🚙🚙🚙🚙🚙🚙🚙💜💜💜💜💜💜💜💜💜💜💜💜💜
💜💜💜💜💜💜💜💜💜💜💜💜💜💜💜🚙🚙🚙🚙🚙🚙🚙🚙🚙🚙🌿🌿🌿🌿🌿🌿🌿🌿🌿🌿🌿🌿🌿🌿🌿🌿🌿🌿🌿🌿🌿🌿🌿🌿🌿🌿🌿🚙🚙🚙🚙🚙🚙🚙🚙🚙🚙🚙🚙🚙🚙🚙🚙🚙💜💜💜💜💜💜💜💜💜💜💜
💜💜💜💜💜💜💜💜💜💜💜💜💜💜💜💜🚙🚙🚙🚙🚙🚙🚙🚙🚙🚙🌿🌿🌿🌿🌿🌿🌿🌿🌿🌿🌿🌿🌿🌿🌿🌿🌿🌿🌿🌿🌿🌿🌿🌿🌿🌿🌿🚙🚙🚙🚙🚙🚙🚙🚙🚙🚙🚙🚙🚙🚙🚙🚙🚙🚙💜💜💜💜💜💜💜💜💜
💜💜💜💜💜💜💜💜💜💜💜💜💜💜💜💜🚙🚙🚙🚙🚙🚙🚙🚙🚙🚙🌿🌿🌿🌿🌿🌿🌿🌿🌿🌿🌿🌿🌿🌿🌿🌿🌿🌿🌿🌿🌿🌿🌿🌿🌿🌿🌿🚙🚙🚙🚙🚙🚙🚙🚙🚙🚙🚙🚙🚙🚙🚙🚙🚙🚙🚙💜💜💜💜💜💜💜💜
💜💜💜💜💜💜💜💜💜💜💜💜💜💜💜💜💜🚙🚙🚙🚙🚙🚙🚙🚙🚙🚙🌿🌿🌿🌿🌿🌿🌿🌿🌿🌿🌿🌿🌿🌿🌿🌿🌿🌿🌿🌿🌿🌿🌿🌿🌿🌿🌿🚙🚙🚙🚙🚙🚙🚙🚙🚙🚙🚙🚙🚙🚙🚙🚙🚙🚙🚙🚙💜💜💜💜💜💜
🚙💜💜💜💜💜💜💜💜💜💜💜💜💜💜💜💜💜🚙🚙🚙🚙🚙🚙🚙🚙🚙🚙🌿🌿🌿🌿🌿🌿🌿🌿🌿🌿🌿🌿🌿🌿🌿🌿🌿🌿🌿🌿🌿🌿🌿🌿🌿🌿🚙🚙🚙🚙🚙🚙🚙🚙🚙🚙🚙🚙🚙🚙🚙🚙🚙🚙🚙🚙🚙🚙💜💜💜💜
🚙💜💜💜💜💜💜💜💜💜💜💜💜💜💜💜💜💜🚙🚙🚙🚙🚙🚙🚙🚙🚙🚙🚙🌿🌿🌿🌿🌿🌿🌿🌿🌿🌿🌿🌿🌿🌿🌿🌿🌿🌿🌿🌿🌿🌿🌿🌿🌿🚙🚙🚙🚙🚙🚙🚙🚙🚙🚙🚙🚙🚙🚙🚙🚙🚙🚙🚙🚙🚙🚙🚙💜💜💜
🚙🚙💜💜💜💜💜💜💜💜💜💜💜💜💜💜💜💜💜🚙🚙🚙🚙🚙🚙🚙🚙🚙🚙🚙🌿🌿🌿🌿🌿🌿🌿🌿🌿🌿🌿🌿🌿🌿🌿🌿🌿🌿🌿🌿🌿🌿🌿🌿🚙🚙🚙🚙🚙🚙🚙🚙🚙🚙🚙🚙🚙🚙🚙🚙🚙🚙🚙🚙🚙🚙🚙🚙💜💜
🚙🚙🚙💜💜💜💜💜💜💜💜💜💜💜💜💜💜💜💜💜🚙🚙🚙🚙🚙🚙🚙🚙🚙🚙🚙🌿🌿🌿🌿🌿🌿🌿🌿🌿🌿🌿🌿🌿🌿🌿🌿🌿🌿🌿🌿🌿🌿🌿🚙🚙🚙🚙🚙🚙🚙🚙🚙🚙🚙🚙🚙🚙🚙🚙🚙🚙🚙🚙🚙🚙🚙🚙💜💜
🚙🚙🚙🚙💜💜💜💜💜💜💜💜💜💜💜💜💜💜💜💜💜🚙🚙🚙🚙🚙🚙🚙🚙🚙🚙🚙🌿🌿🌿🌿🌿🌿🌿🌿🌿🌿🌿🌿🌿🌿🌿🌿🌿🌿🌿🌿🌿🌿🚙🚙🚙🚙🚙🚙🚙🚙🚙🚙🚙🚙🚙🚙🚙🚙🚙🚙🚙🚙🚙🚙🚙🚙💜💜
🚙🚙🚙🚙🚙💜💜💜💜💜💜💜💜💜💜💜💜💜💜💜💜💜🚙🚙🚙🚙🚙🚙🚙🚙🚙🚙🚙🚙🌿🌿🌿🌿🌿🌿🌿🌿🌿🌿🌿🌿🌿🌿🌿🌿🌿🌿🌿🌿🚙🚙🚙🚙🚙🚙🚙🚙🚙🚙🚙🚙🚙🚙🚙🚙🚙🚙🚙🚙🚙🚙🚙💜💜💜
🚙🚙🚙🚙🚙🚙💜💜💜💜💜💜💜💜💜💜💜💜💜💜💜💜💜🚙🚙🚙🚙🚙🚙🚙🚙🚙🚙🚙🚙🌿🌿🌿🌿🌿🌿🌿🌿🌿🌿🌿🌿🌿🌿🌿🌿🌿🌿🚙🚙🚙🚙🚙🚙🚙🚙🚙🚙🚙🚙🚙🚙🚙🚙🚙🚙🚙🚙🚙🚙🚙💜💜💜💜
🚙🚙🚙🚙🚙🚙🚙💜💜💜💜💜💜💜💜💜💜💜💜💜💜💜💜💜🚙🚙🚙🚙🚙🚙🚙🚙🚙🚙🚙🚙🚙🌿🌿🌿🌿🌿🌿🌿🌿🌿🌿🌿🌿🌿🌿🌿🚙🚙🚙🚙🚙🚙🚙🚙🚙🚙🚙🚙🚙🚙🚙🚙🚙🚙🚙🚙🚙🚙🚙💜💜💜💜💜
🚙🚙🚙🚙🚙🚙🚙💜💜💜💜💜💜💜💜💜💜💜💜💜💜💜💜💜💜🚙🚙🚙🚙🚙🚙🚙🚙🚙🚙🚙🚙🚙🚙🌿🌿🌿🌿🌿🌿🌿🌿🌿🌿🌿🌿🚙🚙🚙🚙🚙🚙🚙🚙🚙🚙🚙🚙🚙🚙🚙🚙🚙🚙🚙🚙🚙🚙🚙💜💜💜💜💜💜
🚙🚙🚙🚙🚙🚙🚙🚙🚙💜💜💜💜💜💜💜💜💜💜💜💜💜💜💜💜💜🚙🚙🚙🚙🚙🚙🚙🚙🚙🚙🚙🚙🚙🚙🚙🚙🌿🌿🌿🌿🌿🌿🌿🚙🚙🚙🚙🚙🚙🚙🚙🚙🚙🚙🚙🚙🚙🚙🚙🚙🚙🚙🚙🚙🚙🚙🚙💜💜💜💜💜💜💜
🚙🚙🚙🚙🚙🚙🚙🚙🚙🚙💜💜💜💜💜💜💜💜💜💜💜💜💜💜💜💜💜🚙🚙🚙🚙🚙🚙🚙🚙🚙🚙🚙🚙🚙🚙🚙🚙🚙🚙🚙🚙🚙🚙🚙🚙🚙🚙🚙🚙🚙🚙🚙🚙🚙🚙🚙🚙🚙🚙🚙🚙🚙🚙🚙🚙🚙💜💜💜💜💜💜💜💜
🌿🚙🚙🚙🚙🚙🚙🚙🚙🚙🚙💜💜💜💜💜💜💜💜💜💜💜💜💜💜💜💜💜🚙🚙🚙🚙🚙🚙🚙🚙🚙🚙🚙🚙🚙🚙🚙🚙🚙🚙🚙🚙🚙🚙🚙🚙🚙🚙🚙🚙🚙🚙🚙🚙🚙🚙🚙🚙🚙🚙🚙🚙🚙🚙🚙💜💜💜💜💜💜💜💜💜
🌿🌿🚙🚙🚙🚙🚙🚙🚙🚙🚙🚙💜💜💜💜💜💜💜💜💜💜💜💜💜💜💜💜💜💜🚙🚙🚙🚙🚙🚙🚙🚙🚙🚙🚙🚙🚙🚙🚙🚙🚙🚙🚙🚙🚙🚙🚙🚙🚙🚙🚙🚙🚙🚙🚙🚙🚙🚙🚙🚙🚙🚙🚙💜💜💜💜💜💜💜💜💜💜💜
🌿🌿🌿🚙🚙🚙🚙🚙🚙🚙🚙🚙🚙💜💜💜💜💜💜💜💜💜💜💜💜💜💜💜💜💜💜🚙🚙🚙🚙🚙🚙🚙🚙🚙🚙🚙🚙🚙🚙🚙🚙🚙🚙🚙🚙🚙🚙🚙🚙🚙🚙🚙🚙🚙🚙🚙🚙🚙🚙🚙🚙🚙💜💜💜💜💜💜💜💜💜💜💜💜
🌿🌿🌿🌿🚙🚙🚙🚙🚙🚙🚙🚙🚙🚙💜💜💜💜💜💜💜💜💜💜💜💜💜💜💜💜💜💜🚙🚙🚙🚙🚙🚙🚙🚙🚙🚙🚙🚙🚙🚙🚙🚙🚙🚙🚙🚙🚙🚙🚙🚙🚙🚙🚙🚙🚙🚙🚙🚙🚙🚙🚙💜💜💜💜💜💜💜💜💜💜💜💜💜
🌿🌿🌿🌿🌿🚙🚙🚙🚙🚙🚙🚙🚙🚙🚙💜💜💜💜💜💜💜💜💜💜💜💜💜💜💜💜💜💜🚙🚙🚙🚙🚙🚙🚙🚙🚙🚙🚙🚙🚙🚙🚙🚙🚙🚙🚙🚙🚙🚙🚙🚙🚙🚙🚙🚙🚙🚙🚙🚙🚙💜💜💜💜💜💜💜💜💜💜💜💜💜💜
🌿🌿🌿🌿🌿🌿🚙🚙🚙🚙🚙🚙🚙🚙🚙🚙💜💜💜💜💜💜💜💜💜💜💜💜💜💜💜💜💜💜💜🚙🚙🚙🚙🚙🚙🚙🚙🚙🚙🚙🚙🚙🚙🚙🚙🚙🚙🚙🚙🚙🚙🚙🚙🚙🚙🚙🚙🚙🚙💜💜💜💜💜💜💜💜💜💜💜💜💜💜💜
🌿🌿🌿🌿🌿🌿🌿🚙🚙🚙🚙🚙🚙🚙🚙🚙🚙💜💜💜💜💜💜💜💜💜💜💜💜💜💜💜💜💜💜💜🚙🚙🚙🚙🚙🚙🚙🚙🚙🚙🚙🚙🚙🚙🚙🚙🚙🚙🚙🚙🚙🚙🚙🚙🚙🚙🚙🚙💜💜💜💜💜💜💜💜💜💜💜💜💜💜💜💜
🌿🌿🌿🌿🌿🌿🌿🌿🚙🚙🚙🚙🚙🚙🚙🚙🚙🚙💜💜💜💜💜💜💜💜💜💜💜💜💜💜💜💜💜💜💜🚙🚙🚙🚙🚙🚙🚙🚙🚙🚙🚙🚙🚙🚙🚙🚙🚙🚙🚙🚙🚙🚙🚙🚙🚙💜💜💜💜💜💜💜💜💜💜💜💜💜💜💜💜💜💜
🌿🌿🌿🌿🌿🌿🌿🌿🌿🌿🚙🚙🚙🚙🚙🚙🚙🚙🚙💜💜💜💜💜💜💜💜💜💜💜💜💜💜💜💜💜💜💜💜🚙🚙🚙🚙🚙🚙🚙🚙🚙🚙🚙🚙🚙🚙🚙🚙🚙🚙🚙🚙🚙🚙💜💜💜💜💜💜💜💜💜💜💜💜💜💜💜💜💜💜💜
🌿🌿🌿🌿🌿🌿🌿🌿🌿🌿🌿🚙🚙🚙🚙🚙🚙🚙🚙🚙💜💜💜💜💜💜💜💜💜💜💜💜💜💜💜💜💜💜💜💜🚙🚙🚙🚙🚙🚙🚙🚙🚙🚙🚙🚙🚙🚙🚙🚙🚙🚙🚙🚙💜💜💜💜💜💜💜💜💜💜💜💜💜💜💜💜💜💜💜💜
🌿🌿🌿🌿🌿🌿🌿🌿🌿🌿🌿🌿🚙🚙🚙🚙🚙🚙🚙🚙🚙💜💜💜💜💜💜💜💜💜💜💜💜💜💜💜💜💜💜💜💜💜🚙🚙🚙🚙🚙🚙🚙🚙🚙🚙🚙🚙🚙🚙🚙🚙💜💜💜💜💜💜💜💜💜💜💜💜💜💜💜💜💜💜💜💜💜💜
🌿🌿🌿🌿🌿🌿🌿🌿🌿🌿🌿🌿🌿🚙🚙🚙🚙🚙🚙🚙🚙🚙💜💜💜💜💜💜💜💜💜💜💜💜💜💜💜💜💜💜💜💜💜💜🚙🚙🚙🚙🚙🚙🚙🚙🚙🚙🚙🚙💜💜💜💜💜💜💜💜💜💜💜💜💜💜💜💜💜💜💜💜💜💜💜💜
🌿🌿🌿🌿🌿🌿🌿🌿🌿🌿🌿🌿🌿🚙🚙🚙🚙🚙🚙🚙🚙🚙💜💜💜💜💜💜💜💜💜💜💜💜💜💜💜💜💜💜💜💜💜💜💜💜💜🚙🚙🚙🚙🚙🚙💜💜💜💜💜💜💜💜💜💜💜💜💜💜💜💜💜💜💜💜💜💜💜💜💜💜💜
🌝🌿🌿🌿🌿🌿🌿🌿🌿🌿🌿🌿🌿🌿🚙🚙🚙🚙🚙🚙🚙🚙🚙💜💜💜💜💜💜💜💜💜💜💜💜💜💜💜💜💜💜💜💜💜💜💜💜💜💜💜💜💜💜💜💜💜💜💜💜💜💜💜💜💜💜💜💜💜💜💜💜💜💜💜💜💜💜💜💜💜
🌝🌝🌿🌿🌿🌿🌿🌿🌿🌿🌿🌿🌿🌿🌿🚙🚙🚙🚙🚙🚙🚙🚙🚙💜💜💜💜💜💜💜💜💜💜💜💜💜💜💜💜💜💜💜💜💜💜💜💜💜💜💜💜💜💜💜💜💜💜💜💜💜💜💜💜💜💜💜💜💜💜💜💜💜💜💜💜💜💜💜💜
🌝🌝🌝🌿🌿🌿🌿🌿🌿🌿🌿🌿🌿🌿🌿🌿🚙🚙🚙🚙🚙🚙🚙🚙🚙💜💜💜💜💜💜💜💜💜💜💜💜💜💜💜💜💜💜💜💜💜💜💜💜💜💜💜💜💜💜💜💜💜💜💜💜💜💜💜💜💜💜💜💜💜💜💜💜💜💜💜💜💜💜💜
🌝🌝🌝🌝🌿🌿🌿🌿🌿🌿🌿🌿🌿🌿🌿🌿🚙🚙🚙🚙🚙🚙🚙🚙🚙💜💜💜💜💜💜💜💜💜💜💜💜💜💜💜💜💜💜💜💜💜💜💜💜💜💜💜💜💜💜💜💜💜💜💜💜💜💜💜💜💜💜💜💜💜💜💜💜💜💜💜💜💜💜💜
🌝🌝🌝🌝🌿🌿🌿🌿🌿🌿🌿🌿🌿🌿🌿🌿🌿🚙🚙🚙🚙🚙🚙🚙🚙🚙💜💜💜💜💜💜💜💜💜💜💜💜💜💜💜💜💜💜💜💜💜💜💜💜💜💜💜💜💜💜💜💜💜💜💜💜💜💜💜💜💜💜💜💜💜💜💜💜💜💜💜💜💜💜
🌝🌝🌝🌝🌝🌿🌿🌿🌿🌿🌿🌿🌿🌿🌿🌿🌿🌿🚙🚙🚙🚙🚙🚙🚙🚙🚙💜💜💜💜💜💜💜💜💜💜💜💜💜💜💜💜💜💜💜💜💜💜💜💜💜💜💜💜💜💜💜💜💜💜💜💜💜💜💜💜💜💜💜💜💜💜💜💜💜💜💜💜🚙
🌝🌝🌝🌝🌝🌿🌿🌿🌿🌿🌿🌿🌿🌿🌿🌿🌿🌿🚙🚙🚙🚙🚙🚙🚙🚙🚙💜💜💜💜💜💜💜💜💜💜💜💜💜💜💜💜💜💜💜💜💜💜💜💜💜💜💜💜💜💜💜💜💜💜💜💜💜💜💜💜💜💜💜💜💜💜💜💜💜💜💜🚙🚙
🌝🌝🌝🌝🌝🌝🌿🌿🌿🌿🌿🌿🌿🌿🌿🌿🌿🌿🌿🚙🚙🚙🚙🚙🚙🚙🚙🚙💜💜💜💜💜💜💜💜💜💜💜💜💜💜💜💜💜💜💜💜💜💜💜💜💜💜💜💜💜💜💜💜💜💜💜💜💜💜💜💜💜💜💜💜💜💜💜💜💜🚙🚙🚙
🌝🌝🌝🌝🌝🌝🌿🌿🌿🌿🌿🌿🌿🌿🌿🌿🌿🌿🌿🚙🚙🚙🚙🚙🚙🚙🚙🚙💜💜💜💜💜💜💜💜💜💜💜💜💜💜💜💜💜💜💜💜💜💜💜💜💜💜💜💜💜💜💜💜💜💜💜💜💜💜💜💜💜💜💜💜💜💜💜💜🚙🚙🚙🚙
🌝🌝🌝🌝🌝🌝🌿🌿🌿🌿🌿🌿🌿🌿🌿🌿🌿🌿🌿🚙🚙🚙🚙🚙🚙🚙🚙🚙💜💜💜💜💜💜💜💜💜💜💜💜💜💜💜💜💜💜💜💜💜💜💜💜💜💜💜💜💜💜💜💜💜💜💜💜💜💜💜💜💜💜💜💜💜💜💜🚙🚙🚙🚙🚙
🌝🌝🌝🌝🌝🌝🌿🌿🌿🌿🌿🌿🌿🌿🌿🌿🌿🌿🌿🚙🚙🚙🚙🚙🚙🚙🚙🚙💜💜💜💜💜💜💜💜💜💜💜💜💜💜💜💜💜💜💜💜💜💜💜💜💜💜💜💜💜💜💜💜💜💜💜💜💜💜💜💜💜💜💜💜💜💜🚙🚙🚙🚙🚙🚙
🌝🌝🌝🌝🌝🌝🌿🌿🌿🌿🌿🌿🌿🌿🌿🌿🌿🌿🌿🌿🚙🚙🚙🚙🚙🚙🚙🚙🚙💜💜💜💜💜💜💜💜💜💜💜💜💜💜💜💜💜💜💜💜💜💜💜💜💜💜💜💜💜💜💜💜💜💜💜💜💜💜💜💜💜💜💜💜💜🚙🚙🚙🚙🚙🚙
🌝🌝🌝🌝🌝🌿🌿🌿🌿🌿🌿🌿🌿🌿🌿🌿🌿🌿🌿🌿🚙🚙🚙🚙🚙🚙🚙🚙🚙💜💜💜💜💜💜💜💜💜💜💜💜💜💜💜💜💜💜💜💜💜💜💜💜💜💜💜💜💜💜💜💜💜💜💜💜💜💜💜💜💜💜💜💜🚙🚙🚙🚙🚙🚙🚙
🌝🌝🌝🌝🌿🌿🌿🌿🌿🌿🌿🌿🌿🌿🌿🌿🌿🌿🌿🌿🚙🚙🚙🚙🚙🚙🚙🚙🚙💜💜💜💜💜💜💜💜💜💜💜💜💜💜💜💜💜💜💜💜💜💜💜💜💜💜💜💜💜💜💜💜💜💜💜💜💜💜💜💜💜💜💜💜🚙🚙🚙🚙🚙🚙🚙
🌝🌝🌝🌿🌿🌿🌿🌿🌿🌿🌿🌿🌿🌿🌿🌿🌿🌿🌿🚙🚙🚙🚙🚙🚙🚙🚙🚙🚙💜💜💜💜💜💜💜💜💜💜💜💜💜💜💜💜💜💜💜💜💜💜💜💜💜💜💜💜💜💜💜💜💜💜💜💜💜💜💜💜💜💜💜🚙🚙🚙🚙🚙🚙🚙🚙
🌝🌿🌿🌿🌿🌿🌿🌿🌿🌿🌿🌿🌿🌿🌿🌿🌿🌿🌿🚙🚙🚙🚙🚙🚙🚙🚙🚙🚙💜💜💜💜💜💜💜💜💜💜💜💜💜💜💜💜💜💜💜💜💜💜💜💜💜💜💜💜💜💜💜💜💜💜💜💜💜💜💜💜💜💜💜🚙🚙🚙🚙🚙🚙🚙🚙
🌿🌿🌿🌿🌿🌿🌿🌿🌿🌿🌿🌿🌿🌿🌿🌿🌿🌿🌿🚙🚙🚙🚙🚙🚙🚙🚙🚙🚙💜💜💜💜💜💜💜💜💜💜💜💜💜💜💜💜💜💜💜💜💜💜💜💜💜💜💜💜💜💜💜💜💜💜💜💜💜💜💜💜💜💜💜🚙🚙🚙🚙🚙🚙🚙🚙
🌿🌿🌿🌿🌿🌿🌿🌿🌿🌿🌿🌿🌿🌿🌿🌿🌿🌿🌿🚙🚙🚙🚙🚙🚙🚙🚙🚙💜💜💜💜💜💜💜💜💜💜💜💜💜💜💜💜💜💜💜💜💜💜💜💜💜💜💜💜💜💜💜💜💜💜💜💜💜💜💜💜💜💜💜💜🚙🚙🚙🚙🚙🚙🚙🚙
🌿🌿🌿🌿🌿🌿🌿🌿🌿🌿🌿🌿🌿🌿🌿🌿🌿🌿🚙🚙🚙🚙🚙🚙🚙🚙🚙🚙💜💜💜💜💜💜💜💜💜💜💜💜💜💜💜💜💜💜💜💜💜💜💜💜💜💜💜💜💜💜💜💜💜💜💜💜💜💜💜💜💜💜💜💜🚙🚙🚙🚙🚙🚙🚙🚙
🌿🌿🌿🌿🌿🌿🌿🌿🌿🌿🌿🌿🌿🌿🌿🌿🌿🌿🚙🚙🚙🚙🚙🚙🚙🚙🚙🚙💜💜💜💜💜💜💜💜💜💜💜💜💜💜💜💜💜💜💜💜💜💜💜💜💜💜💜💜💜💜💜💜💜💜💜💜💜💜💜💜💜💜💜💜🚙🚙🚙🚙🚙🚙🚙🚙
🌿🌿🌿🌿🌿🌿🌿🌿🌿🌿🌿🌿🌿🌿🌿🌿🌿🚙🚙🚙🚙🚙🚙🚙🚙🚙🚙💜💜💜💜💜💜💜💜💜💜💜💜💜💜💜💜💜💜💜💜💜💜💜💜💜💜💜💜💜💜💜💜💜💜💜💜💜💜💜💜💜💜💜💜💜🚙🚙🚙🚙🚙🚙🚙🚙
🌿🌿🌿🌿🌿🌿🌿🌿🌿🌿🌿🌿🌿🌿🌿🌿🚙🚙🚙🚙🚙🚙🚙🚙🚙🚙🚙💜💜💜💜💜💜💜💜💜💜💜💜💜💜💜💜💜💜💜💜💜💜💜💜💜💜💜💜💜💜💜💜💜💜💜💜💜💜💜💜💜💜💜💜💜🚙🚙🚙🚙🚙🚙🚙🚙
🌿🌿🌿🌿🌿🌿🌿🌿🌿🌿🌿🌿🌿🌿🌿🚙🚙🚙🚙🚙🚙🚙🚙🚙🚙🚙💜💜💜💜💜💜💜💜💜💜💜💜💜💜💜💜💜💜💜💜💜💜💜💜💜💜💜💜💜💜💜💜💜💜💜💜💜💜💜💜💜💜💜💜💜💜🚙🚙🚙🚙🚙🚙🚙🚙
🌿🌿🌿🌿🌿🌿🌿🌿🌿🌿🌿🌿🌿🌿🚙🚙🚙🚙🚙🚙🚙🚙🚙🚙🚙💜💜💜💜💜💜💜💜💜💜💜💜💜💜💜💜💜💜💜💜💜💜💜💜💜💜💜💜💜💜💜💜💜💜💜💜💜💜💜💜💜💜💜💜💜💜💜💜🚙🚙🚙🚙🚙🚙🚙
🌿🌿🌿🌿🌿🌿🌿🌿🌿🌿🌿🌿🚙🚙🚙🚙🚙🚙🚙🚙🚙🚙🚙🚙🚙💜💜💜💜💜💜💜💜💜💜💜💜💜💜💜💜💜💜💜💜💜💜💜💜💜💜💜💜💜💜💜💜💜💜💜💜💜💜💜💜💜💜💜💜💜💜💜💜🚙🚙🚙🚙🚙🚙🚙
🌿🌿🌿🌿🌿🌿🌿🌿🌿🌿🚙🚙🚙🚙🚙🚙🚙🚙🚙🚙🚙🚙🚙🚙💜💜💜💜💜💜💜💜💜💜💜💜💜💜💜💜💜💜💜💜💜💜💜💜💜💜💜💜💜💜💜💜💜💜💜💜💜💜💜💜💜💜💜💜💜💜💜💜💜🚙🚙🚙🚙🚙🚙🚙
🌿🌿🌿🌿🌿🌿🌿🚙🚙🚙🚙🚙🚙🚙🚙🚙🚙🚙🚙🚙🚙🚙🚙💜💜💜💜💜💜💜💜💜💜💜💜💜💜💜💜💜💜💜💜💜💜💜💜💜💜💜💜💜💜💜💜💜💜💜💜💜💜💜💜💜💜💜💜💜💜💜💜💜💜💜🚙🚙🚙🚙🚙🚙
🚙🚙🚙🚙🚙🚙🚙🚙🚙🚙🚙🚙🚙🚙🚙🚙🚙🚙🚙🚙🚙🚙💜💜💜💜💜💜💜💜💜💜💜💜💜💜💜💜💜💜💜💜💜💜💜💜💜💜💜💜💜💜💜💜💜💜💜💜💜💜💜💜💜💜💜💜💜💜💜💜💜💜💜💜🚙🚙🚙🚙🚙🚙
🚙🚙🚙🚙🚙🚙🚙🚙🚙🚙🚙🚙🚙🚙🚙🚙🚙🚙🚙🚙🚙💜💜💜💜💜💜💜💜💜💜💜💜💜💜💜💜💜💜💜💜💜💜💜💜💜💜💜💜💜💜💜💜💜💜💜💜💜💜💜💜💜💜💜💜💜💜💜💜💜💜💜💜💜💜🚙🚙🚙🚙🚙
🚙🚙🚙🚙🚙🚙🚙🚙🚙🚙🚙🚙🚙🚙🚙🚙🚙🚙🚙🚙💜💜💜💜💜💜💜💜💜💜💜💜💜💜💜💜💜💜💜💜💜💜💜💜🚙🚙🚙🚙🚙🚙🚙🚙🚙🚙💜💜💜💜💜💜💜💜💜💜💜💜💜💜💜💜💜💜💜💜💜💜🚙🚙🚙🚙
🚙🚙🚙🚙🚙🚙🚙🚙🚙🚙🚙🚙🚙🚙🚙🚙🚙🚙💜💜💜💜💜💜💜💜💜💜💜💜💜💜💜💜💜💜💜💜💜💜💜💜🚙🚙🚙🚙🚙🚙🚙🚙🚙🚙🚙🚙🚙🚙💜💜💜💜💜💜💜💜💜💜💜💜💜💜💜💜💜💜💜💜🚙🚙🚙🚙
🚙🚙🚙🚙🚙🚙🚙🚙🚙🚙🚙🚙🚙🚙🚙🚙🚙💜💜💜💜💜💜💜💜💜💜💜💜💜💜💜💜💜💜💜💜💜💜💜🚙🚙🚙🚙🚙🚙🚙🚙🚙🚙🚙🚙🚙🚙🚙🚙🚙🚙💜💜💜💜💜💜💜💜💜💜💜💜💜💜💜💜💜💜💜🚙🚙🚙
🚙🚙🚙🚙🚙🚙🚙🚙🚙🚙🚙🚙🚙🚙🚙💜💜💜💜💜💜💜💜💜💜💜💜💜💜💜💜💜💜💜💜💜💜💜🚙🚙🚙🚙🚙🚙🚙🚙🚙🚙🚙🚙🚙🚙🚙🚙🚙🚙🚙🚙🚙💜💜💜💜💜💜💜💜💜💜💜💜💜💜💜💜💜💜💜🚙🚙
🚙🚙🚙🚙🚙🚙🚙🚙🚙🚙🚙🚙🚙💜💜💜💜💜💜💜💜💜💜💜💜💜💜💜💜💜💜💜💜💜💜💜🚙🚙🚙🚙🚙🚙🚙🚙🚙🚙🚙🚙🚙🚙🚙🚙🚙🚙🚙🚙🚙🚙🚙🚙🚙💜💜💜💜💜💜💜💜💜💜💜💜💜💜💜💜💜💜🚙
🚙🚙🚙🚙🚙🚙🚙🚙🚙🚙💜💜💜💜💜💜💜💜💜💜💜💜💜💜💜💜💜💜💜💜💜💜💜💜💜🚙🚙🚙🚙🚙🚙🚙🚙🚙🚙🚙🚙🚙🚙🚙🚙🚙🚙🚙🚙🚙🚙🚙🚙🚙🚙🚙💜💜💜💜💜💜💜💜💜💜💜💜💜💜💜💜💜💜
💜💜💜💜💜💜💜💜💜💜💜💜💜💜💜💜💜💜💜💜💜💜💜💜💜💜💜💜💜💜💜💜💜💜🚙🚙🚙🚙🚙🚙🚙🚙🚙🚙🚙🚙🚙🚙🚙🚙🚙🚙🚙🚙🚙🚙🚙🚙🚙🚙🚙🚙🚙💜💜💜💜💜💜💜💜💜💜💜💜💜💜💜💜💜
💜💜💜💜💜💜💜💜💜💜💜💜💜💜💜💜💜💜💜💜💜💜💜💜💜💜💜💜💜💜💜💜🚙🚙🚙🚙🚙🚙🚙🚙🚙🚙🚙🚙🚙🚙🚙🚙🚙🚙🚙🚙🚙🚙🚙🚙🚙🚙🚙🚙🚙🚙🚙🚙🚙💜💜💜💜💜💜💜💜💜💜💜💜💜💜💜
💜💜💜💜💜💜💜💜💜💜💜💜💜💜💜💜💜💜💜💜💜💜💜💜💜💜💜💜💜💜💜🚙🚙🚙🚙🚙🚙🚙🚙🚙🚙🚙🚙🚙🚙🚙🚙🚙🚙🚙🚙🚙🚙🚙🚙🚙🚙🚙🚙🚙🚙🚙🚙🚙🚙🚙💜💜💜💜💜💜💜💜💜💜💜💜💜💜
💜💜💜💜💜💜💜💜💜💜💜💜💜💜💜💜💜💜💜💜💜💜💜💜💜💜💜💜💜💜🚙🚙🚙🚙🚙🚙🚙🚙🚙🚙🚙🚙🚙🌿🌿🌿🌿🌿🌿🌿🌿🌿🌿🌿🚙🚙🚙🚙🚙🚙🚙🚙🚙🚙🚙🚙🚙💜💜💜💜💜💜💜💜💜💜💜💜💜
