💜💜💜💜💜💜💜💜💜💜💜💜💜💜💜💜💜💜💜💜💜💜💜🚙🚙🚙🚙🚙🚙🚙🚙🚙🚙🚙🚙🚙🚙🚙🚙🚙🚙🚙🚙🚙🚙🚙🚙🚙🚙🚙🚙🚙🚙🚙🚙🚙🚙🚙🚙🚙🚙🚙🚙🚙🚙🚙🚙🚙🚙🚙🚙🚙💜💜💜💜💜💜💜💜
💜💜💜💜💜💜💜💜💜💜💜💜💜💜💜💜💜💜💜💜💜💜💜💜🚙🚙🚙🚙🚙🚙🚙🚙🚙🚙🚙🚙🚙🚙🚙🚙🚙🚙🚙🚙🚙🚙🚙🚙🚙🚙🚙🚙🚙🚙🚙🚙🚙🚙🚙🚙🚙🚙🚙🚙🚙🚙🚙🚙🚙🚙🚙🚙🚙💜💜💜💜💜💜💜
💜💜💜💜💜💜💜💜💜💜💜💜💜💜💜💜💜💜💜💜💜💜💜💜💜🚙🚙🚙🚙🚙🚙🚙🚙🚙🚙🚙🚙🚙🚙🚙🚙🚙🚙🚙🚙🚙🚙🚙🚙🚙🚙🚙🚙🚙🚙🚙🚙🚙🚙🚙🚙🚙🚙🚙🚙🚙🚙🚙🚙🚙🚙🚙🚙🚙💜💜💜💜💜💜
💜💜💜💜💜💜💜💜💜💜💜💜💜💜💜💜💜💜💜💜💜💜💜💜💜🚙🚙🚙🚙🚙🚙🚙🚙🚙🚙🚙🚙🚙🚙🚙🚙🚙🚙🚙🚙🚙🚙🚙🚙🚙🚙🚙🚙🚙🚙🚙🚙🚙🚙🚙🚙🚙🚙🚙🚙🚙🚙🚙🚙🚙🚙🚙🚙🚙🚙🚙💜💜💜💜
💜💜💜💜💜💜💜💜💜💜💜💜💜💜💜💜💜💜💜💜💜💜💜💜💜💜🚙🚙🚙🚙🚙🚙🚙🚙🚙🚙🚙🚙🚙🚙🚙🚙🚙🚙🚙🚙🚙🚙🚙🚙🚙🚙🚙🚙🚙🚙🚙🚙🚙🚙🚙🚙🚙🚙🚙🚙🚙🚙🚙🚙🚙🚙🚙🚙🚙🚙🚙💜💜💜
💜💜💜💜💜💜💜💜💜💜💜💜💜💜💜💜💜💜💜💜💜💜💜💜💜💜💜🚙🚙🚙🚙🚙🚙🚙🚙🚙🚙🚙🚙🚙🚙🚙🚙🚙🚙🚙🚙🚙🚙🚙🌿🌿🌿🌿🚙🚙🚙🚙🚙🚙🚙🚙🚙🚙🚙🚙🚙🚙🚙🚙🚙🚙🚙🚙🚙🚙🚙🚙💜💜
💜💜💜💜💜💜💜💜💜💜💜💜💜💜💜💜💜💜💜💜💜💜💜💜💜💜💜🚙🚙🚙🚙🚙🚙🚙🚙🚙🚙🚙🚙🚙🚙🚙🚙🚙🚙🚙🚙🚙🌿🌿🌿🌿🌿🌿🌿🌿🌿🚙🚙🚙🚙🚙🚙🚙🚙🚙🚙🚙🚙🚙🚙🚙🚙🚙🚙🚙🚙🚙🚙💜
💜💜💜💜💜💜💜💜💜💜💜💜💜💜💜💜💜💜💜💜💜💜💜💜💜💜💜💜🚙🚙🚙🚙🚙🚙🚙🚙🚙🚙🚙🚙🚙🚙🚙🚙🚙🚙🚙🌿🌿🌿🌿🌿🌿🌿🌿🌿🌿🌿🌿🌿🚙🚙🚙🚙🚙🚙🚙🚙🚙🚙🚙🚙🚙🚙🚙🚙🚙🚙🚙🚙
💜💜💜💜💜💜💜💜💜💜💜💜💜💜💜💜💜💜💜💜💜💜💜💜💜💜💜💜🚙🚙🚙🚙🚙🚙🚙🚙🚙🚙🚙🚙🚙🚙🚙🚙🚙🚙🌿🌿🌿🌿🌿🌿🌿🌿🌿🌿🌿🌿🌿🌿🌿🌿🚙🚙🚙🚙🚙🚙🚙🚙🚙🚙🚙🚙🚙🚙🚙🚙🚙🚙
💜💜💜💜💜💜💜💜💜💜💜💜💜💜💜💜💜💜💜💜💜💜💜💜💜💜💜💜🚙🚙🚙🚙🚙🚙🚙🚙🚙🚙🚙🚙🚙🚙🚙🚙🚙🚙🌿🌿🌿🌿🌿🌿🌿🌿🌿🌿🌿🌿🌿🌿🌿🌿🌿🚙🚙🚙🚙🚙🚙🚙🚙🚙🚙🚙🚙🚙🚙🚙🚙🚙
💜💜💜💜💜💜💜💜💜💜💜💜💜💜💜💜💜💜💜💜💜💜💜💜💜💜💜💜💜🚙🚙🚙🚙🚙🚙🚙🚙🚙🚙🚙🚙🚙🚙🚙🚙🌿🌿🌿🌿🌿🌿🌿🌿🌿🌿🌿🌿🌿🌿🌿🌿🌿🌿🌿🌿🚙🚙🚙🚙🚙🚙🚙🚙🚙🚙🚙🚙🚙🚙🚙
💜💜💜💜💜💜💜💜💜💜💜💜💜💜💜💜💜💜💜💜💜💜💜💜💜💜💜💜💜🚙🚙🚙🚙🚙🚙🚙🚙🚙🚙🚙🚙🚙🚙🚙🚙🌿🌿🌿🌿🌿🌿🌿🌿🌿🌿🌿🌿🌿🌿🌿🌿🌿🌿🌿🌿🌿🌿🚙🚙🚙🚙🚙🚙🚙🚙🚙🚙🚙🚙🚙
💜💜💜💜💜💜💜💜💜💜💜💜💜💜💜💜💜💜💜💜💜💜💜💜💜💜💜💜💜🚙🚙🚙🚙🚙🚙🚙🚙🚙🚙🚙🚙🚙🚙🚙🌿🌿🌿🌿🌿🌿🌿🌿🌿🌿🌿🌿🌿🌿🌿🌿🌿🌿🌿🌿🌿🌿🌿🌿🚙🚙🚙🚙🚙🚙🚙🚙🚙🚙🚙🚙
💜💜💜💜💜💜💜💜💜💜💜💜💜💜💜💜💜💜💜💜💜💜💜💜💜💜💜💜💜🚙🚙🚙🚙🚙🚙🚙🚙🚙🚙🚙🚙🚙🚙🚙🌿🌿🌿🌿🌿🌿🌿🌿🌿🌿🌿🌿🌿🌿🌿🌿🌿🌿🌿🌿🌿🌿🌿🌿🌿🌿🚙🚙🚙🚙🚙🚙🚙🚙🚙🚙
💜💜💜💜💜💜💜💜💜💜💜💜💜💜💜💜💜💜💜💜💜💜💜💜💜💜💜💜💜🚙🚙🚙🚙🚙🚙🚙🚙🚙🚙🚙🚙🚙🚙🚙🌿🌿🌿🌿🌿🌿🌿🌿🌿🌿🌿🌿🌿🌿🌿🌿🌿🌿🌿🌿🌿🌿🌿🌿🌿🌿🌿🚙🚙🚙🚙🚙🚙🚙🚙🚙
💜💜💜💜💜💜💜💜💜💜💜💜💜💜💜💜💜💜💜💜💜💜💜💜💜💜💜💜💜💜🚙🚙🚙🚙🚙🚙🚙🚙🚙🚙🚙🚙🚙🌿🌿🌿🌿🌿🌿🌿🌿🌿🌿🌿🌿🌿🌿🌿🌿🌿🌿🌿🌿🌿🌿🌿🌿🌿🌿🌿🌿🌿🌿🚙🚙🚙🚙🚙🚙🚙
💜💜💜💜💜💜💜💜💜💜💜💜💜💜💜💜💜💜💜💜💜💜💜💜💜💜💜💜💜💜🚙🚙🚙🚙🚙🚙🚙🚙🚙🚙🚙🚙🚙🌿🌿🌿🌿🌿🌿🌿🌿🌿🌿🌿🌿🌿🌿🌿🌿🌿🌿🌿🌿🌿🌿🌿🌿🌿🌿🌿🌿🌿🌿🌿🚙🚙🚙🚙🚙🚙
💜💜💜💜💜💜💜💜💜💜💜💜💜💜💜💜💜💜💜💜💜💜💜💜💜💜💜💜💜💜🚙🚙🚙🚙🚙🚙🚙🚙🚙🚙🚙🚙🚙🌿🌿🌿🌿🌿🌿🌿🌿🌿🌿🌿🌿🌿🌿🌿🌿🌿🌿🌿🌿🌿🌿🌿🌿🌿🌿🌿🌿🌿🌿🌿🌿🌿🚙🚙🚙🚙
💜💜💜💜💜💜💜💜💜💜💜💜💜💜💜💜💜💜💜💜💜💜💜💜💜💜💜💜💜💜🚙🚙🚙🚙🚙🚙🚙🚙🚙🚙🚙🚙🚙🌿🌿🌿🌿🌿🌿🌿🌿🌿🌿🌿🌿🌿🌿🌿🌿🌿🌿🌿🌿🌿🌿🌿🌿🌿🌿🌿🌿🌿🌿🌿🌿🌿🌿🚙🚙🚙
💜💜💜💜💜💜💜💜💜💜💜💜💜💜💜💜💜💜💜💜💜💜💜💜💜💜💜💜💜💜🚙🚙🚙🚙🚙🚙🚙🚙🚙🚙🚙🚙🌿🌿🌿🌿🌿🌿🌿🌿🌿🌿🌿🌿🌿🌿🌿🌿🌿🌿🌿🌿🌿🌿🌿🌿🌿🌿🌿🌿🌿🌿🌿🌿🌿🌿🌿🌿🌿🚙
💜💜💜💜💜💜💜💜💜💜💜💜💜💜💜💜💜💜💜💜💜💜💜💜💜💜💜💜💜💜🚙🚙🚙🚙🚙🚙🚙🚙🚙🚙🚙🚙🌿🌿🌿🌿🌿🌿🌿🌿🌿🌿🌿🌿🌿🌿🌿🌿🌿🌿🌿🌿🌿🌿🌿🌿🌿🌿🌿🌿🌿🌿🌿🌿🌿🌿🌿🌿🌿🌿
💜💜💜💜💜💜💜💜💜💜💜💜💜💜💜💜💜💜💜💜💜💜💜💜💜💜💜💜💜💜🚙🚙🚙🚙🚙🚙🚙🚙🚙🚙🚙🚙🌿🌿🌿🌿🌿🌿🌿🌿🌿🌿🌿🌿🌿🌿🌿🌿🌿🌿🌿🌿🌿🌿🌿🌿🌿🌿🌿🌿🌿🌿🌿🌿🌿🌿🌿🌿🌿🌿
💜💜💜💜💜💜💜💜💜💜💜💜💜💜💜💜💜💜💜💜💜💜💜💜💜💜💜💜💜💜🚙🚙🚙🚙🚙🚙🚙🚙🚙🚙🚙🚙🌿🌿🌿🌿🌿🌿🌿🌿🌿🌿🌿🌿🌿🌿🌿🌿🌿🌿🌿🌿🌿🌿🌿🌿🌿🌿🌿🌿🌿🌿🌿🌿🌿🌿🌿🌿🌿🌿
💜💜💜💜💜💜💜💜💜💜💜💜💜💜💜💜💜💜💜💜💜💜💜💜💜💜💜💜💜💜🚙🚙🚙🚙🚙🚙🚙🚙🚙🚙🚙🚙🌿🌿🌿🌿🌿🌿🌿🌿🌿🌿🌿🌿🌿🌿🌿🌿🌿🌿🌿🌿🌿🌿🌿🌿🌿🌿🌿🌿🌿🌿🌿🌿🌿🌿🌿🌿🌿🌿
💜💜💜💜💜💜💜💜💜💜💜💜💜💜💜💜💜💜💜💜💜💜💜💜💜💜💜💜💜🚙🚙🚙🚙🚙🚙🚙🚙🚙🚙🚙🚙🚙🌿🌿🌿🌿🌿🌿🌿🌿🌿🌿🌿🌿🌿🌿🌿🌿🌿🌿🌿🌿🌿🌿🌿🌿🌿🌿🌿🌿🌿🌿🌿🌿🌿🌿🌿🌿🌿🌿
💜💜💜💜💜💜💜💜💜💜💜💜💜💜💜💜💜💜💜💜💜💜💜💜💜💜💜💜💜🚙🚙🚙🚙🚙🚙🚙🚙🚙🚙🚙🚙🚙🌿🌿🌿🌿🌿🌿🌿🌿🌿🌿🌿🌿🌿🌿🌿🌿🌿🌿🌿🌿🌿🌿🌿🌿🌿🌿🌿🌿🌿🌿🌿🌿🌿🌿🌿🌿🌿🌿
💜💜💜💜💜💜💜💜💜💜💜💜💜💜💜💜💜💜💜💜💜💜💜💜💜💜💜💜💜🚙🚙🚙🚙🚙🚙🚙🚙🚙🚙🚙🚙🚙🌿🌿🌿🌿🌿🌿🌿🌿🌿🌿🌿🌿🌿🌿🌿🌿🌿🌿🌿🌿🌿🌿🌿🌿🌿🌿🌿🌿🌿🌿🌿🌿🌿🌿🌿🌿🌿🌿
💜💜💜💜💜💜💜💜💜💜💜💜💜💜💜💜💜💜💜💜💜💜💜💜💜💜💜💜💜🚙🚙🚙🚙🚙🚙🚙🚙🚙🚙🚙🚙🌿🌿🌿🌿🌿🌿🌿🌿🌿🌿🌿🌿🌿🌿🌿🌿🌿🌿🌿🌿🌿🌿🌿🌿🌿🌿🌿🌿🌿🌿🌿🌿🌿🌿🌿🌿🌿🌿🌿
💜💜💜💜💜💜💜💜💜💜💜💜💜💜💜💜💜💜💜💜💜💜💜💜💜💜💜💜💜🚙🚙🚙🚙🚙🚙🚙🚙🚙🚙🚙🚙🌿🌿🌿🌿🌿🌿🌿🌿🌿🌿🌿🌿🌿🌿🌿🌿🌿🌿🌿🌿🌿🌿🌿🌿🌿🌿🌿🌿🌿🌿🌿🌿🌿🌿🌿🌿🌿🌿🌿
💜💜💜💜💜💜💜💜💜💜💜💜💜💜💜💜💜💜💜💜💜💜💜💜💜💜💜💜💜🚙🚙🚙🚙🚙🚙🚙🚙🚙🚙🚙🚙🌿🌿🌿🌿🌿🌿🌿🌿🌿🌿🌿🌿🌿🌿🌿🌿🌿🌿🌿🌿🌿🌿🌿🌿🌿🌿🌿🌿🌿🌿🌿🌿🌿🌿🌿🌿🌿🌿🌿
💜💜💜💜💜💜💜💜💜💜💜💜💜💜💜💜💜💜💜💜💜💜💜💜💜💜💜💜💜🚙🚙🚙🚙🚙🚙🚙🚙🚙🚙🚙🚙🚙🌿🌿🌿🌿🌿🌿🌿🌿🌿🌿🌿🌿🌿🌿🌿🌿🌿🌿🌿🌿🌿🌿🌿🌿🌿🌿🌿🌿🌿🌿🌿🌿🌿🌿🌿🌿🌿🌿
💜💜💜💜💜💜💜💜💜💜💜💜💜💜💜💜💜💜💜💜💜💜💜💜💜💜💜💜💜🚙🚙🚙🚙🚙🚙🚙🚙🚙🚙🚙🚙🚙🌿🌿🌿🌿🌿🌿🌿🌿🌿🌿🌿🌿🌿🌿🌿🌿🌿🌿🌿🌿🌿🌿🌿🌝🌝🌝🌿🌿🌿🌿🌿🌿🌿🌿🌿🌿🌿🌿
💜💜💜💜💜💜💜💜💜💜💜💜💜💜💜💜💜💜💜💜💜💜💜💜💜💜💜💜🚙🚙🚙🚙🚙🚙🚙🚙🚙🚙🚙🚙🚙🚙🌿🌿🌿🌿🌿🌿🌿🌿🌿🌿🌿🌿🌿🌿🌿🌿🌿🌿🌿🌿🌿🌿🌝🌝🌝🌝🌝🌝🌿🌿🌿🌿🌿🌿🌿🌿🌿🌿
💜💜💜💜💜💜💜💜💜💜💜💜💜💜💜💜💜💜💜💜💜💜💜💜💜💜💜💜🚙🚙🚙🚙🚙🚙🚙🚙🚙🚙🚙🚙🚙🚙🌿🌿🌿🌿🌿🌿🌿🌿🌿🌿🌿🌿🌿🌿🌿🌿🌿🌿🌿🌿🌿🌿🌝🌝🌝🌝🌝🌝🌝🌝🌿🌿🌿🌿🌿🌿🌿🌿
💜💜💜💜💜💜💜💜💜💜💜💜💜💜💜💜💜💜💜💜💜💜💜💜💜💜💜💜🚙🚙🚙🚙🚙🚙🚙🚙🚙🚙🚙🚙🚙🚙🌿🌿🌿🌿🌿🌿🌿🌿🌿🌿🌿🌿🌿🌿🌿🌿🌿🌿🌿🌿🌿🌿🌿🌝🌝🌝🌝🌝🌝🌝🌝🌝🌿🌿🌿🌿🌿🌿
💜💜💜💜💜💜💜💜💜💜💜💜💜💜💜💜💜💜💜💜💜💜💜💜💜💜💜💜🚙🚙🚙🚙🚙🚙🚙🚙🚙🚙🚙🚙🚙🚙🌿🌿🌿🌿🌿🌿🌿🌿🌿🌿🌿🌿🌿🌿🌿🌿🌿🌿🌿🌿🌿🌿🌿🌝🌝🌝🌝🌝🌝🌝🌝🌝🌝🌿🌿🌿🌿🌿
💜💜💜💜💜💜💜💜💜💜💜💜💜💜💜💜💜💜💜💜💜💜💜💜💜💜💜💜🚙🚙🚙🚙🚙🚙🚙🚙🚙🚙🚙🚙🚙🚙🚙🌿🌿🌿🌿🌿🌿🌿🌿🌿🌿🌿🌿🌿🌿🌿🌿🌿🌿🌿🌿🌿🌿🌿🌝🌝🌝🌝🌝🌝🌝🌝🌝🌝🌿🌿🌿🌿
💜💜💜💜💜💜💜💜💜💜💜💜💜💜💜💜💜💜💜💜💜💜💜💜💜💜💜🚙🚙🚙🚙🚙🚙🚙🚙🚙🚙🚙🚙🚙🚙🚙🚙🌿🌿🌿🌿🌿🌿🌿🌿🌿🌿🌿🌿🌿🌿🌿🌿🌿🌿🌿🌿🌿🌿🌿🌿🌿🌝🌝🌝🌝🌝🌝🌝🌝🌝🌿🌿🌿
💜💜💜💜💜💜💜💜💜💜💜💜💜💜💜💜💜💜💜💜💜💜💜💜💜💜💜🚙🚙🚙🚙🚙🚙🚙🚙🚙🚙🚙🚙🚙🚙🚙🚙🚙🌿🌿🌿🌿🌿🌿🌿🌿🌿🌿🌿🌿🌿🌿🌿🌿🌿🌿🌿🌿🌿🌿🌿🌿🌿🌿🌝🌝🌝🌝🌝🌝🌝🌝🌿🌿
💜💜💜💜💜💜💜💜💜💜💜💜💜💜💜💜💜💜💜💜💜💜💜💜💜💜💜🚙🚙🚙🚙🚙🚙🚙🚙🚙🚙🚙🚙🚙🚙🚙🚙🚙🌿🌿🌿🌿🌿🌿🌿🌿🌿🌿🌿🌿🌿🌿🌿🌿🌿🌿🌿🌿🌿🌿🌿🌿🌿🌿🌿🌿🌿🌝🌝🌝🌝🌝🌝🌿
💜💜💜💜💜💜💜💜💜💜💜💜💜💜💜💜💜💜💜💜💜💜💜💜💜💜💜🚙🚙🚙🚙🚙🚙🚙🚙🚙🚙🚙🚙🚙🚙🚙🚙🚙🚙🌿🌿🌿🌿🌿🌿🌿🌿🌿🌿🌿🌿🌿🌿🌿🌿🌿🌿🌿🌿🌿🌿🌿🌿🌿🌿🌿🌿🌿🌿🌿🌿🌿🌿🌿
💜💜💜💜💜💜💜💜💜💜💜💜💜💜💜💜💜💜💜💜💜💜💜💜💜💜🚙🚙🚙🚙🚙🚙🚙🚙🚙🚙🚙🚙🚙🚙🚙🚙🚙🚙🚙🚙🌿🌿🌿🌿🌿🌿🌿🌿🌿🌿🌿🌿🌿🌿🌿🌿🌿🌿🌿🌿🌿🌿🌿🌿🌿🌿🌿🌿🌿🌿🌿🌿🌿🌿
💜💜💜💜💜💜💜💜💜💜💜💜💜💜💜💜💜💜💜💜💜💜💜💜💜💜🚙🚙🚙🚙🚙🚙🚙🚙🚙🚙🚙🚙🚙🚙🚙🚙🚙🚙🚙🚙🌿🌿🌿🌿🌿🌿🌿🌿🌿🌿🌿🌿🌿🌿🌿🌿🌿🌿🌿🌿🌿🌿🌿🌿🌿🌿🌿🌿🌿🌿🌿🌿🌿🌿
💜💜💜💜💜💜💜💜💜💜💜💜💜💜💜💜💜💜💜💜💜💜💜💜💜💜🚙🚙🚙🚙🚙🚙🚙🚙🚙🚙🚙🚙🚙🚙🚙🚙🚙🚙🚙🚙🚙🚙🌿🌿🌿🌿🌿🌿🌿🌿🌿🌿🌿🌿🌿🌿🌿🌿🌿🌿🌿🌿🌿🌿🌿🌿🌿🌿🌿🌿🌿🌿🌿🌿
💜💜💜💜💜💜💜💜💜💜💜💜💜💜💜💜💜💜💜💜💜💜💜💜💜🚙🚙🚙🚙🚙🚙🚙🚙🚙🚙🚙🚙🚙🚙🚙🚙🚙🚙🚙🚙🚙🚙🚙🚙🌿🌿🌿🌿🌿🌿🌿🌿🌿🌿🌿🌿🌿🌿🌿🌿🌿🌿🌿🌿🌿🌿🌿🌿🌿🌿🌿🌿🌿🌿🌿
💜💜💜💜💜💜💜💜💜💜💜💜💜💜💜💜💜💜💜💜💜💜💜💜💜🚙🚙🚙🚙🚙🚙🚙🚙🚙🚙🚙🚙🚙🚙🚙🚙🚙🚙🚙🚙🚙🚙🚙🚙🚙🌿🌿🌿🌿🌿🌿🌿🌿🌿🌿🌿🌿🌿🌿🌿🌿🌿🌿🌿🌿🌿🌿🌿🌿🌿🌿🌿🌿🌿🌿
💜💜💜💜💜💜💜💜💜💜💜💜💜💜💜💜💜💜💜💜💜💜💜💜💜🚙🚙🚙🚙🚙🚙🚙🚙🚙🚙🚙🚙🚙🚙🚙🚙🚙🚙🚙🚙🚙🚙🚙🚙🚙🚙🚙🌿🌿🌿🌿🌿🌿🌿🌿🌿🌿🌿🌿🌿🌿🌿🌿🌿🌿🌿🌿🌿🌿🌿🌿🌿🌿🌿🌿
💜💜💜💜💜💜💜💜💜💜💜💜💜💜💜💜💜💜💜💜💜💜💜💜🚙🚙🚙🚙🚙🚙🚙🚙🚙🚙🚙🚙🚙🚙🚙🚙🚙🚙🚙🚙🚙🚙🚙🚙🚙🚙🚙🚙🚙🌿🌿🌿🌿🌿🌿🌿🌿🌿🌿🌿🌿🌿🌿🌿🌿🌿🌿🌿🌿🌿🌿🌿🌿🌿🌿🌿
💜💜💜💜💜💜💜💜💜💜💜💜💜💜💜💜💜💜💜💜💜💜💜🚙🚙🚙🚙🚙🚙🚙🚙🚙🚙🚙🚙🚙🚙🚙🚙🚙🚙🚙🚙🚙🚙🚙🚙🚙🚙🚙🚙🚙🚙🚙🚙🌿🌿🌿🌿🌿🌿🌿🌿🌿🌿🌿🌿🌿🌿🌿🌿🌿🌿🌿🌿🌿🌿🌿🌿🌿
💜💜💜💜💜💜💜💜💜💜💜💜💜💜💜💜💜💜💜💜💜💜🚙🚙🚙🚙🚙🚙🚙🚙🚙🚙🚙🚙🚙🚙🚙🚙🚙🚙🚙🚙🚙🚙🚙🚙🚙🚙🚙🚙🚙🚙🚙🚙🚙🚙🚙🌿🌿🌿🌿🌿🌿🌿🌿🌿🌿🌿🌿🌿🌿🌿🌿🌿🌿🌿🌿🌿🌿🌿
💜💜💜💜💜💜💜💜💜💜💜💜💜💜💜💜💜💜💜💜🚙🚙🚙🚙🚙🚙🚙🚙🚙🚙🚙🚙🚙🚙🚙🚙🚙🚙🚙🚙🚙🚙🚙🚙🚙🚙🚙🚙🚙🚙🚙🚙🚙🚙🚙🚙🚙🚙🚙🚙🌿🌿🌿🌿🌿🌿🌿🌿🌿🌿🌿🌿🌿🌿🌿🌿🌿🌿🌿🌿
🚙🚙🚙🚙🚙🚙🚙🚙🚙🚙🚙🚙🚙🚙🚙🚙🚙🚙🚙🚙🚙🚙🚙🚙🚙🚙🚙🚙🚙🚙🚙🚙🚙🚙🚙🚙🚙🚙🚙🚙🚙🚙🚙🚙🚙🚙🚙🚙🚙🚙🚙🚙🚙🚙🚙🚙🚙🚙🚙🚙🚙🚙🌿🌿🌿🌿🌿🌿🌿🌿🌿🌿🌿🌿🌿🌿🌿🌿🌿🌿
🚙🚙🚙🚙🚙🚙🚙🚙🚙🚙🚙🚙🚙🚙🚙🚙🚙🚙🚙🚙🚙🚙🚙🚙🚙🚙🚙🚙🚙🚙🚙🚙🚙🚙🚙🚙🚙🚙🚙🚙🚙🚙🚙🚙🚙🚙🚙🚙🚙🚙🚙🚙🚙🚙🚙🚙🚙🚙🚙🚙🚙🚙🚙🚙🌿🌿🌿🌿🌿🌿🌿🌿🌿🌿🌿🌿🌿🌿🌿🌿
🚙🚙🚙🚙🚙🚙🚙🚙🚙🚙🚙🚙🚙🚙🚙🚙🚙🚙🚙🚙🚙🚙🚙🚙🚙🚙🚙🚙🚙🚙🚙🚙🚙🚙🚙🚙🚙🚙🚙🚙🚙🚙🚙🚙🚙🚙🚙🚙🚙🚙🚙🚙🚙🚙🚙🚙🚙🚙🚙🚙🚙🚙🚙🚙🚙🚙🌿🌿🌿🌿🌿🌿🌿🌿🌿🌿🌿🌿🌿🌿
🚙🚙🚙🚙🚙🚙🚙🚙🚙🚙🚙🚙🚙🚙🚙🚙🚙🚙🚙🚙🚙🚙🚙🚙🚙🚙💜💜💜💜💜💜💜💜💜💜🚙🚙🚙🚙🚙🚙🚙🚙🚙🚙🚙🚙🚙🚙🚙🚙🚙🚙🚙🚙🚙🚙🚙🚙🚙🚙🚙🚙🚙🚙🚙🚙🚙🌿🌿🌿🌿🌿🌿🌿🌿🌿🌿🌿
🚙🚙🚙🚙🚙🚙🚙🚙🚙🚙🚙🚙🚙🚙🚙🚙🚙🚙🚙🚙🚙🚙🚙🚙💜💜💜💜💜💜💜💜💜💜💜💜💜💜💜💜💜💜🚙🚙🚙🚙🚙🚙🚙🚙🚙🚙🚙🚙🚙🚙🚙🚙🚙🚙🚙🚙🚙🚙🚙🚙🚙🚙🚙🚙🚙🌿🌿🌿🌿🌿🌿🌿🌿🌿
🚙🚙🚙🚙🚙🚙🚙🚙🚙🚙🚙🚙🚙🚙🚙🚙🚙🚙🚙🚙🚙🚙🚙💜💜💜💜💜💜💜💜💜💜💜💜💜💜💜💜💜💜💜💜💜💜💜💜🚙🚙🚙🚙🚙🚙🚙🚙🚙🚙🚙🚙🚙🚙🚙🚙🚙🚙🚙🚙🚙🚙🚙🚙🚙🚙🌿🌿🌿🌿🌿🌿🌿
🚙🚙🚙🚙🚙🚙🚙🚙🚙🚙🚙🚙🚙🚙🚙🚙🚙🚙🚙🚙🚙🚙🚙💜💜💜💜💜💜💜💜💜💜💜💜💜💜💜💜💜💜💜💜💜💜💜💜💜💜💜🚙🚙🚙🚙🚙🚙🚙🚙🚙🚙🚙🚙🚙🚙🚙🚙🚙🚙🚙🚙🚙🚙🚙🚙🚙🌿🌿🌿🌿🌿
🚙🚙🚙🚙🚙🚙🚙🚙🚙🚙🚙🚙🚙🚙🚙🚙🚙🚙🚙🚙🚙🚙💜💜💜💜💜💜💜💜💜💜💜💜💜💜💜💜💜💜💜💜💜💜💜💜💜💜💜💜💜💜💜💜🚙🚙🚙🚙🚙🚙🚙🚙🚙🚙🚙🚙🚙🚙🚙🚙🚙🚙🚙🚙🚙🚙🚙🌿🌿🌿
🚙🚙🚙🚙🚙🚙🚙🚙🚙🚙🚙🚙🚙🚙🚙🚙🚙🚙🚙🚙🚙💜💜💜💜💜💜💜💜💜💜💜💜💜💜💜💜💜💜💜💜💜💜💜💜💜💜💜💜💜💜💜💜💜💜💜💜🚙🚙🚙🚙🚙🚙🚙🚙🚙🚙🚙🚙🚙🚙🚙🚙🚙🚙🚙🚙🚙🚙🌿
🚙🚙🚙🚙🚙🚙🚙🚙🚙🚙🚙🚙🚙🚙🚙🚙🚙🚙🚙🚙🚙💜💜💜💜💜💜💜💜💜💜💜💜💜💜💜💜💜💜💜💜💜💜💜💜💜💜💜💜💜💜💜💜💜💜💜💜💜💜💜🚙🚙🚙🚙🚙🚙🚙🚙🚙🚙🚙🚙🚙🚙🚙🚙🚙🚙🚙🚙
🚙🚙🚙🚙🚙🚙🚙🚙🚙🚙🚙🚙🚙🚙🚙🚙🚙🚙🚙🚙💜💜💜💜💜💜💜💜💜💜💜💜💜💜💜💜💜💜💜💜💜💜💜💜💜💜💜💜💜💜💜💜💜💜💜💜💜💜💜💜💜💜🚙🚙🚙🚙🚙🚙🚙🚙🚙🚙🚙🚙🚙🚙🚙🚙🚙🚙
🚙🚙🚙🚙🚙🚙🚙🚙🚙🚙🚙🚙🚙🚙🚙🚙🚙🚙🚙💜💜💜💜💜💜💜💜💜💜💜💜💜💜💜💜💜💜💜💜💜💜💜💜💜💜💜💜💜💜💜💜💜💜💜💜💜💜💜💜💜💜💜💜💜🚙🚙🚙🚙🚙🚙🚙🚙🚙🚙🚙🚙🚙🚙🚙🚙
🚙🚙🚙🚙🚙🚙🚙🚙🚙🚙🚙🚙🚙🚙🚙🚙🚙🚙🚙💜💜💜💜💜💜💜💜💜💜💜💜💜💜💜💜💜💜💜💜💜💜💜💜💜💜💜💜💜💜💜💜💜💜💜💜💜💜💜💜💜💜💜💜💜💜💜🚙🚙🚙🚙🚙🚙🚙🚙🚙🚙🚙🚙🚙🚙
🚙🚙🚙🚙🚙🚙🚙🚙🚙🚙🚙🚙🚙🚙🚙🚙🚙🚙💜💜💜💜💜💜💜💜💜💜💜💜💜💜💜💜💜💜💜💜💜💜💜💜💜💜💜💜💜💜💜💜💜💜💜💜💜💜💜💜💜💜💜💜💜💜💜💜💜💜🚙🚙🚙🚙🚙🚙🚙🚙🚙🚙🚙🚙
🚙🚙🚙🚙🚙🚙🚙🚙🚙🚙🚙🚙🚙🚙🚙🚙🚙💜💜💜💜💜💜💜💜💜💜💜💜💜💜💜💜💜💜💜💜💜💜💜💜💜💜💜💜💜💜💜💜💜💜💜💜💜💜💜💜💜💜💜💜💜💜💜💜💜💜💜💜💜🚙🚙🚙🚙🚙🚙🚙🚙🚙🚙
🚙🚙🚙🚙🚙🚙🚙🚙🚙🚙🚙🚙🚙🚙🚙🚙💜💜💜💜💜💜💜💜💜💜💜💜💜💜💜💜💜💜💜💜💜💜💜💜💜💜💜💜💜💜💜💜💜💜💜💜💜💜💜💜💜💜💜💜💜💜💜💜💜💜💜💜💜💜💜💜🚙🚙🚙🚙🚙🚙🚙🚙
🚙🚙🚙🚙🚙🚙🚙🚙🚙🚙🚙🚙🚙🚙🚙💜💜💜💜💜💜💜💜💜💜💜💜💜💜💜💜💜💜💜💜💜💜💜💜💜💜💜💜💜💜💜💜💜💜💜💜💜💜💜💜💜💜💜💜💜💜💜💜💜💜💜💜💜💜💜💜💜💜🚙🚙🚙🚙🚙🚙🚙
🚙🚙🚙🚙🚙🚙🚙🚙🚙🚙🚙🚙🚙💜💜💜💜💜💜💜💜💜💜💜💜💜💜💜💜💜💜💜💜💜💜💜💜💜💜💜💜💜💜💜💜💜💜💜💜💜💜💜💜💜💜💜💜💜💜💜💜💜💜💜💜💜💜💜💜💜💜💜💜💜💜🚙🚙🚙🚙🚙
🚙🚙🚙🚙🚙🚙🚙🚙🚙🚙🚙🚙💜💜💜💜💜💜💜💜💜💜💜💜💜💜💜💜💜💜💜💜💜💜💜💜💜💜💜💜💜💜💜💜💜💜💜💜💜💜💜💜💜💜💜💜💜💜💜💜💜💜💜💜💜💜💜💜💜💜💜💜💜💜💜💜🚙🚙🚙🚙
🚙🚙🚙🚙🚙🚙🚙🚙🚙💜💜💜💜💜💜💜💜💜💜💜💜💜💜💜💜💜💜💜💜💜💜💜💜💜💜💜💜💜💜💜💜💜💜💜💜💜💜💜💜💜💜💜💜💜💜💜💜💜💜💜💜💜💜💜💜💜💜💜💜💜💜💜💜💜💜💜💜🚙🚙🚙
🚙🚙🚙🚙💜💜💜💜💜💜💜💜💜💜💜💜💜💜💜💜💜💜💜💜💜💜💜💜💜💜💜💜💜💜💜💜💜💜💜💜💜💜💜💜💜💜💜💜💜💜💜💜💜💜💜💜💜💜💜💜💜💜💜💜💜💜💜💜💜💜💜💜💜💜💜💜💜💜💜🚙
💜💜💜💜💜💜💜💜💜💜💜💜💜💜💜💜💜💜💜💜💜💜💜💜💜💜💜💜💜💜💜💜💜💜💜💜💜💜💜💜💜💜💜💜💜💜💜💜💜💜💜💜💜💜💜💜💜💜💜💜💜💜💜💜💜💜💜💜💜💜💜💜💜💜💜💜💜💜💜💜
💜💜💜💜💜💜💜💜💜💜💜💜💜💜💜💜💜💜💜💜💜💜💜💜💜💜💜💜💜💜💜💜💜💜💜💜💜💜💜💜💜💜💜💜💜💜💜💜💜💜💜💜💜💜💜💜💜💜💜💜💜💜💜💜💜💜💜💜💜💜💜💜💜💜💜💜💜💜💜💜
💜💜💜💜💜💜💜💜💜💜💜💜💜💜💜💜💜💜💜💜💜💜💜💜💜💜💜💜💜💜💜💜💜💜💜💜💜💜💜💜💜💜💜💜💜💜💜💜💜💜💜💜💜💜💜💜💜💜💜💜💜💜💜💜💜💜💜💜💜💜💜💜💜💜💜💜💜💜💜💜
💜💜💜💜💜💜💜💜💜💜💜💜💜💜💜💜💜💜💜💜💜💜💜💜💜💜💜💜💜💜💜💜💜💜💜💜💜💜💜💜💜💜💜💜💜💜💜💜💜💜💜💜💜💜💜💜💜💜💜💜💜💜💜💜💜💜💜💜💜💜💜💜💜💜💜💜💜💜💜💜
💜💜💜💜💜💜💜💜💜💜💜💜💜💜💜💜💜💜💜💜💜💜💜💜💜💜💜💜💜💜💜💜💜💜💜💜💜💜💜💜💜💜💜💜💜💜💜💜💜💜💜💜💜💜💜💜💜💜💜💜💜💜💜💜💜💜💜💜💜💜💜💜💜💜💜💜💜💜💜💜
💜💜💜💜💜💜💜💜💜💜💜💜💜💜💜💜💜💜💜💜💜💜💜💜💜💜💜💜💜💜💜💜💜💜💜💜💜💜💜💜💜💜💜💜💜💜💜💜💜💜💜💜💜💜💜💜💜💜💜💜💜💜💜💜💜💜💜💜💜💜💜💜💜💜💜💜💜💜💜💜
💜💜💜💜💜💜💜💜💜💜💜💜💜💜💜💜💜💜💜💜💜💜💜💜💜💜💜💜💜💜💜💜💜💜💜💜💜💜💜💜💜💜💜💜💜💜💜💜💜💜💜💜💜💜💜💜💜💜💜💜💜💜💜💜💜💜💜💜💜💜💜💜💜💜💜💜💜💜💜💜
💜💜💜💜💜💜💜💜💜💜💜💜💜💜💜💜💜💜💜💜💜💜💜💜💜💜💜💜💜💜💜💜💜💜💜💜💜💜💜💜💜💜💜💜💜💜💜💜💜💜💜💜💜💜💜💜💜💜💜💜💜💜💜💜💜💜💜💜💜💜💜💜💜💜💜💜💜💜💜💜
