💜💜💜💜💜💜💜💜💜💜💜💜💜💜💜💜💜💜💜💜💜💜💜💜💜💜💜💜💜💜💜💜💜💜💜💜💜💜💜💜💜💜💜💜💜💜💜💜💜💜💜💜💜💜💜💜💜💜💜💜💜💜💜💜💜💜💜💜💜💜💜💜💜💜💜💜💜💜💜💜
💜💜💜💜💜💜💜💜💜💜💜💜💜💜💜💜💜💜💜💜💜💜💜💜💜💜💜💜💜💜💜💜💜💜💜💜💜💜💜💜💜💜💜💜💜💜💜💜💜💜💜💜💜💜💜💜💜💜💜💜💜💜💜💜💜💜💜💜💜💜💜💜💜💜💜💜💜💜💜💜
🚙🚙🚙🚙🚙🚙🚙🚙🚙🚙🚙🚙🚙🚙🚙🚙🚙🚙🚙🚙🚙🚙🚙🚙🚙🚙🚙🚙🚙🚙🚙🚙🚙🚙🚙🚙🚙🚙🚙🚙🚙🚙🚙🚙🚙🚙🚙🚙🚙🚙🚙🚙🚙🚙🚙🚙💜💜💜💜💜💜💜💜💜💜💜💜💜💜💜💜💜💜💜💜💜💜💜💜
🚙🚙🚙🚙🚙🚙🚙🚙🚙🚙🚙🚙🚙🚙🚙🚙🚙🚙🚙🚙🚙🚙🚙🚙🚙🚙🚙🚙🚙🚙🚙🚙🚙🚙🚙🚙🚙🚙🚙🚙🚙🚙🚙🚙🚙🚙🚙🚙🚙🚙🚙🚙🚙🚙🚙🚙🚙🚙🚙🚙🚙🚙🚙🚙🚙🚙🚙🚙🚙🚙🚙🚙🚙🚙🚙🚙🚙🚙🚙🚙
🚙🚙🚙🚙🚙🚙🚙🚙🚙🚙🚙🚙🚙🚙🚙🚙🚙🚙🚙🚙🚙🚙🚙🚙🚙🚙🚙🚙🚙🚙🚙🚙🚙🚙🚙🚙🚙🚙🚙🚙🚙🚙🚙🚙🚙🚙🚙🚙🚙🚙🚙🚙🚙🚙🚙🚙🚙🚙🚙🚙🚙🚙🚙🚙🚙🚙🚙🚙🚙🚙🚙🚙🚙🚙🚙🚙🚙🚙🚙🚙
🚙🚙🚙🚙🚙🚙🚙🚙🚙🚙🚙🚙🚙🚙🚙🚙🚙🚙🚙🚙🚙🚙🚙🚙🚙🚙🚙🚙🚙🚙🚙🚙🚙🚙🚙🚙🚙🚙🚙🚙🚙🚙🚙🚙🚙🚙🚙🚙🚙🚙🚙🚙🚙🚙🚙🚙🚙🚙🚙🚙🚙🚙🚙🚙🚙🚙🚙🚙🚙🚙🚙🚙🚙🚙🚙🚙🚙🚙🚙🚙
🌿🌿🌿🌿🌿🌿🌿🌿🌿🌿🌿🌿🌿🌿🌿🌿🌿🌿🌿🌿🌿🌿🌿🌿🌿🌿🌿🌿🌿🌿🌿🌿🌿🌿🌿🌿🌿🌿🌿🌿🌿🌿🌿🌿🌿🌿🌿🌿🌿🌿🌿🌿🌿🌿🚙🚙🚙🚙🚙🚙🚙🚙🚙🚙🚙🚙🚙🚙🚙🚙🚙🚙🚙🚙🚙🚙🚙🚙🚙🚙
🌿🌿🌿🌿🌿🌿🌿🌿🌿🌿🌿🌿🌿🌿🌿🌿🌿🌿🌿🌿🌿🌿🌿🌿🌿🌿🌿🌿🌿🌿🌿🌿🌿🌿🌿🌿🌿🌿🌿🌿🌿🌿🌿🌿🌿🌿🌿🌿🌿🌿🌿🌿🌿🌿🌿🌿🌿🌿🌿🌿🌿🌿🌿🌿🌿🌿🌿🌿🌿🌿🌿🌿🌿🌿🌿🌿🌿🌿🌿🌿
🌿🌿🌿🌿🌿🌿🌿🌿🌿🌿🌿🌿🌿🌿🌿🌿🌿🌿🌿🌿🌿🌿🌿🌿🌿🌿🌿🌿🌿🌿🌿🌿🌿🌿🌿🌿🌿🌿🌿🌿🌿🌿🌿🌿🌿🌿🌿🌿🌿🌿🌿🌿🌿🌿🌿🌿🌿🌿🌿🌿🌿🌿🌿🌿🌿🌿🌿🌿🌿🌿🌿🌿🌿🌿🌿🌿🌿🌿🌿🌿
🌿🌿🌿🌿🌿🌿🌿🌿🌿🌿🌿🌿🌿🌿🌿🌿🌿🌿🌿🌿🌿🌿🌿🌿🌿🌿🌿🌿🌿🌿🌿🌿🌿🌿🌿🌿🌿🌿🌿🌿🌿🌿🌿🌿🌿🌿🌿🌿🌿🌿🌿🌿🌿🌿🌿🌿🌿🌿🌿🌿🌿🌿🌿🌿🌿🌿🌿🌿🌿🌿🌿🌿🌿🌿🌿🌿🌿🌿🌿🌿
🌝🌝🌝🌝🌝🌝🌝🌝🌝🌝🌝🌝🌝🌝🌝🌝🌝🌝🌝🌝🌝🌝🌝🌝🌝🌝🌝🌝🌝🌝🌝🌝🌝🌝🌝🌝🌝🌝🌝🌝🌝🌝🌝🌝🌝🌝🌝🌝🌝🌝🌝🌿🌿🌿🌿🌿🌿🌿🌿🌿🌿🌿🌿🌿🌿🌿🌿🌿🌿🌿🌿🌿🌿🌿🌿🌿🌿🌿🌿🌿
🌝🌝🌝🌝🌝🌝🌝🌝🌝🌝🌝🌝🌝🌝🌝🌝🌝🌝🌝🌝🌝🌝🌝🌝🌝🌝🌝🌝🌝🌝🌝🌝🌝🌝🌝🌝🌝🌝🌝🌝🌝🌝🌝🌝🌝🌝🌝🌝🌝🌝🌝🌝🌝🌝🌝🌝🌝🌝🌝🌝🌝🌝🌝🌝🌝🌝🌝🌝🌝🌝🌝🌝🌝🌝🌝🌝🌝🌝🌝🌝
🌝🌝🌝🌝🌝🌝🌝🌝🌝🌝🌝🌝🌝🌝🌝🌝🌝🌝🌝🌝🌝🌝🌝🌝🌝🌝🌝🌝🌝🌝🌝🌝🌝🌝🌝🌝🌝🌝🌝🌝🌝🌝🌝🌝🌝🌝🌝🌝🌝🌝🌝🌝🌝🌝🌝🌝🌝🌝🌝🌝🌝🌝🌝🌝🌝🌝🌝🌝🌝🌝🌝🌝🌝🌝🌝🌝🌝🌝🌝🌝
📙📙📙📙📙📙📙📙📙📙📙📙📙📙📙📙📙📙📙📙📙📙📙📙📙📙📙📙📙📙📙📙📙📙📙📙📙🌝🌝🌝🌝🌝🌝🌝🌝🌝🌝🌝🌝🌝🌝🌝🌝🌝🌝🌝🌝🌝🌝🌝🌝🌝🌝🌝🌝🌝🌝🌝🌝🌝🌝🌝🌝🌝🌝🌝🌝🌝🌝🌝
📙📙📙📙📙📙📙📙📙📙📙📙📙📙📙📙📙📙📙📙📙📙📙📙📙📙📙📙📙📙📙📙📙📙📙📙📙📙📙📙📙📙📙📙📙📙📙📙📙🌝🌝🌝🌝🌝🌝🌝🌝🌝🌝🌝🌝🌝🌝🌝🌝🌝🌝🌝🌝🌝🌝🌝🌝🌝🌝🌝🌝🌝🌝🌝
📙📙📙📙📙📙📙📙📙📙📙📙📙📙📙📙📙📙📙📙📙📙📙📙📙📙📙📙📙📙📙📙📙📙📙📙📙📙📙📙📙📙📙📙📙📙📙📙📙📙📙📙📙📙📙📙📙📙📙📙📙🌝🌝🌝🌝🌝🌝🌝🌝🌝🌝🌝🌝🌝📙📙📙📙📙📙
🎒🎒🎒🎒🎒🎒🎒🎒🎒🎒🎒🎒🎒🎒🎒🎒🎒🎒🎒🎒🎒🎒🎒🎒🎒🎒🎒🎒🎒🎒🎒🎒📙📙📙📙📙📙📙📙📙📙📙📙📙📙📙📙📙📙📙📙📙📙📙📙📙📙📙📙📙📙📙📙📙📙📙📙📙📙📙📙📙📙📙📙📙📙📙📙
🎒🎒🎒🎒🎒🎒🎒🎒🎒🎒🎒🎒🎒🎒🎒🎒🎒🎒🎒🎒🎒🎒🎒🎒🎒🎒🎒🎒🎒🎒🎒🎒🎒🎒🎒🎒🎒🎒🎒🎒📙📙📙📙📙📙📙📙📙📙📙📙📙📙📙📙📙📙📙📙📙📙📙📙📙📙📙📙📙📙📙📙📙📙📙📙📙📙📙📙
🎒🎒🎒🎒🎒🎒🎒🎒🎒🎒🎒🎒🎒🎒🎒🎒🎒🎒🎒🎒🎒🎒🎒🎒🎒🎒🎒🎒🎒🎒🎒🎒🎒🎒🎒🎒🎒🎒🎒🎒🎒🎒🎒🎒🎒🎒📙📙📙📙📙📙📙📙📙📙📙📙📙📙📙📙📙📙📙📙📙📙📙📙📙📙📙📙📙📙📙📙📙📙
🎒🎒🎒🎒🎒🎒🎒🎒🎒🎒🎒🎒🎒🎒🎒🎒🎒🎒🎒🎒🎒🎒🎒🎒🎒🎒🎒🎒🎒🎒🎒🎒🎒🎒🎒🎒🎒🎒🎒🎒🎒🎒🎒🎒🎒🎒🎒🎒🎒🎒🎒📙📙📙📙📙📙📙📙📙📙📙📙📙📙📙📙📙📙📙📙📙📙📙📙📙📙📙📙📙
🎒🎒🎒🎒🎒🎒🎒🎒🎒🎒🎒🎒🎒🎒🎒🎒🎒🎒🎒🎒🎒🎒🎒🎒🎒🎒🎒🎒🎒🎒🎒🎒🎒🎒🎒🎒🎒🎒🎒🎒🎒🎒🎒🎒🎒🎒🎒🎒🎒🎒🎒🎒🎒🎒🎒📙📙📙📙📙📙📙📙📙📙📙📙📙📙📙📙📙📙📙📙📙📙📙📙📙
🎒🎒🎒🎒🎒📙📙📙📙📙📙📙📙📙📙📙📙📙📙📙📙📙🎒🎒🎒🎒🎒🎒🎒🎒🎒🎒🎒🎒🎒🎒🎒🎒🎒🎒🎒🎒🎒🎒🎒🎒🎒🎒🎒🎒🎒🎒🎒🎒🎒🎒🎒🎒🎒📙📙📙📙📙📙📙📙📙📙📙📙📙📙📙📙📙🎒🎒🎒🎒
📙📙📙📙📙📙📙📙📙📙📙📙📙📙📙📙📙📙📙📙📙📙📙📙📙📙📙📙📙🎒🎒🎒🎒🎒🎒🎒🎒🎒🎒🎒🎒🎒🎒🎒🎒🎒🎒🎒🎒🎒🎒🎒🎒🎒🎒🎒🎒🎒🎒🎒🎒🎒🎒🎒🎒🎒📙📙🎒🎒🎒🎒🎒🎒🎒🎒🎒🎒🎒🎒
📙📙📙📙📙📙📙📙📙📙📙📙📙📙📙📙📙📙📙📙📙📙📙📙📙📙📙📙📙📙📙📙📙📙🎒🎒🎒🎒🎒🎒🎒🎒🎒🎒🎒🎒🎒🎒🎒🎒🎒🎒🎒🎒🎒🎒🎒🎒🎒🎒🎒🎒🎒🎒🎒🎒🎒🎒🎒🎒🎒🎒🎒🎒🎒🎒🎒🎒🎒🎒
📙📙📙📙📙📙🌝🌝🌝🌝🌝🌝🌝🌝🌝🌝🌝🌝🌝🌝🌝🌝📙📙📙📙📙📙📙📙📙📙📙📙📙📙📙🎒🎒🎒🎒🎒🎒🎒🎒🎒🎒🎒🎒🎒🎒🎒🎒🎒🎒🎒🎒🎒🎒🎒🎒🎒🎒🎒🎒🎒🎒🎒🎒🎒🎒🎒🎒🎒🎒🎒🎒🎒🎒🎒
🌝🌝🌝🌝🌝🌝🌝🌝🌝🌝🌝🌝🌝🌝🌝🌝🌝🌝🌝🌝🌝🌝🌝🌝🌝🌝🌝🌝📙📙📙📙📙📙📙📙📙📙📙🎒🎒🎒🎒🎒🎒🎒🎒🎒🎒🎒🎒🎒🎒🎒🎒🎒🎒🎒🎒🎒🎒🎒🎒🎒🎒🎒🎒🎒🎒🎒🎒🎒🎒🎒🎒🎒🎒🎒🎒🎒
🌝🌝🌝🌝🌝🌝🌝🌝🌝🌝🌝🌝🌝🌝🌝🌝🌝🌝🌝🌝🌝🌝🌝🌝🌝🌝🌝🌝🌝🌝🌝📙📙📙📙📙📙📙📙📙📙🎒🎒🎒🎒🎒🎒🎒🎒🎒🎒🎒🎒🎒🎒🎒🎒🎒🎒🎒🎒🎒🎒🎒🎒🎒🎒🎒🎒🎒🎒🎒🎒🎒🎒🎒🎒🎒🎒🎒
🌝🌝🌝🌝🌝🌝🌝🌝🌿🌿🌿🌿🌿🌿🌿🌿🌿🌿🌿🌿🌝🌝🌝🌝🌝🌝🌝🌝🌝🌝🌝🌝🌝📙📙📙📙📙📙📙📙📙🎒🎒🎒🎒🎒🎒🎒🎒🎒🎒🎒🎒🎒🎒🎒🎒🎒🎒🎒🎒🎒🎒🎒🎒🎒🎒🎒🎒🎒🎒🎒🎒🎒🎒🎒🎒🎒🎒
🌝🌝🌿🌿🌿🌿🌿🌿🌿🌿🌿🌿🌿🌿🌿🌿🌿🌿🌿🌿🌿🌿🌿🌿🌿🌝🌝🌝🌝🌝🌝🌝🌝🌝🌝📙📙📙📙📙📙📙📙📙🎒🎒🎒🎒🎒🎒🎒🎒🎒🎒🎒🎒🎒🎒🎒🎒🎒🎒🎒🎒🎒🎒🎒🎒🎒🎒🎒🎒🎒🎒🎒🎒🎒🎒🎒🎒
🌿🌿🌿🌿🌿🌿🌿🌿🌿🌿🌿🌿🌿🌿🌿🌿🌿🌿🌿🌿🌿🌿🌿🌿🌿🌿🌿🌿🌝🌝🌝🌝🌝🌝🌝🌝🌝📙📙📙📙📙📙📙📙🎒🎒🎒🎒🎒🎒🎒🎒🎒🎒🎒🎒🎒🎒🎒🎒🎒🎒🎒🎒🎒🎒🎒🎒🎒🎒🎒🎒🎒🎒🎒🎒🎒🎒🎒
🌿🌿🌿🌿🌿🌿🌿🌿🌿🌿🌿🌿🌿🌿🌿🌿🌿🌿🌿🌿🌿🌿🌿🌿🌿🌿🌿🌿🌿🌿🌝🌝🌝🌝🌝🌝🌝🌝📙📙📙📙📙📙📙🎒🎒🎒🎒🎒🎒🎒🎒🎒🎒🎒🎒🎒🎒🎒🎒🎒🎒🎒🎒🎒🎒🎒🎒🎒🎒🎒🎒🎒🎒🎒🎒🎒🎒🎒
🌿🌿🌿🌿🌿🌿🌿🚙🚙🚙🚙🚙🚙🚙🚙🚙🚙🚙🚙🚙🚙🚙🌿🌿🌿🌿🌿🌿🌿🌿🌿🌿🌝🌝🌝🌝🌝🌝🌝📙📙📙📙📙📙📙🎒🎒🎒🎒🎒🎒🎒🎒🎒🎒🎒🎒🎒🎒🎒🎒🎒🎒🎒🎒🎒🎒🎒🎒🎒🎒🎒🎒🎒🎒🎒🎒🎒🎒
🌿🌿🌿🚙🚙🚙🚙🚙🚙🚙🚙🚙🚙🚙🚙🚙🚙🚙🚙🚙🚙🚙🚙🚙🚙🌿🌿🌿🌿🌿🌿🌿🌿🌝🌝🌝🌝🌝🌝🌝📙📙📙📙📙📙🎒🎒🎒🎒🎒🎒🎒🎒🎒🎒🎒🎒🎒🎒🎒🎒🎒🎒🎒🎒🎒🎒🎒🎒🎒🎒🎒🎒🎒🎒🎒🎒🎒🎒
🌿🚙🚙🚙🚙🚙🚙🚙🚙🚙🚙🚙🚙🚙🚙🚙🚙🚙🚙🚙🚙🚙🚙🚙🚙🚙🚙🌿🌿🌿🌿🌿🌿🌿🌝🌝🌝🌝🌝🌝📙📙📙📙📙📙🎒🎒🎒🎒🎒🎒🎒🎒🎒🎒🎒🎒🎒🎒🎒🎒🎒🎒🎒🎒🎒🎒🎒🎒🎒🎒🎒🎒🎒🎒🎒🎒🎒🎒
🚙🚙🚙🚙🚙🚙🚙🚙🚙🚙🚙🚙🚙🚙🚙🚙🚙🚙🚙🚙🚙🚙🚙🚙🚙🚙🚙🚙🌿🌿🌿🌿🌿🌿🌿🌝🌝🌝🌝🌝🌝📙📙📙📙📙🎒🎒🎒🎒🎒🎒🎒🎒🎒🎒🎒🎒🎒🎒🎒🎒🎒🎒🎒🎒🎒🎒🎒🎒🎒🎒🎒🎒🎒🎒🎒🎒🎒🎒
🚙🚙🚙🚙🚙🚙🚙🚙🚙🚙🚙💜💜💜💜💜💜💜🚙🚙🚙🚙🚙🚙🚙🚙🚙🚙🚙🌿🌿🌿🌿🌿🌿🌝🌝🌝🌝🌝🌝📙📙📙📙📙🎒🎒🎒🎒🎒🎒🎒🎒🎒🎒🎒🎒🎒🎒🎒🎒🎒🎒🎒🎒🎒🎒🎒🎒🎒🎒🎒🎒🎒🎒🎒🎒🎒🎒
🚙🚙🚙🚙🚙🚙🚙🚙💜💜💜💜💜💜💜💜💜💜💜💜💜🚙🚙🚙🚙🚙🚙🚙🚙🚙🌿🌿🌿🌿🌿🌿🌝🌝🌝🌝🌝📙📙📙📙📙🎒🎒🎒🎒🎒🎒🎒🎒🎒🎒🎒🎒🎒🎒🎒🎒🎒📙📙📙📙📙📙📙🎒🎒🎒🎒🎒🎒🎒🎒🎒🎒
🚙🚙🚙🚙🚙🚙🚙💜💜💜💜💜💜💜💜💜💜💜💜💜💜💜💜🚙🚙🚙🚙🚙🚙🚙🌿🌿🌿🌿🌿🌿🌝🌝🌝🌝🌝📙📙📙📙📙🎒🎒🎒🎒🎒🎒🎒🎒🎒🎒🎒🎒🎒🎒📙📙📙📙📙📙📙📙📙📙📙📙🎒🎒🎒🎒🎒🎒🎒🎒
🚙🚙🚙🚙🚙🚙💜💜💜💜💜💜💜💜💜💜💜💜💜💜💜💜💜💜🚙🚙🚙🚙🚙🚙🚙🌿🌿🌿🌿🌿🌝🌝🌝🌝🌝📙📙📙📙📙🎒🎒🎒🎒🎒🎒🎒🎒🎒🎒🎒🎒🎒📙📙📙📙📙📙📙📙📙📙📙📙📙📙📙🎒🎒🎒🎒🎒🎒
🚙🚙🚙🚙🚙💜💜💜💜💜💜💜💜💜💜💜💜💜💜💜💜💜💜💜🚙🚙🚙🚙🚙🚙🚙🌿🌿🌿🌿🌿🌝🌝🌝🌝🌝📙📙📙📙🎒🎒🎒🎒🎒🎒🎒🎒🎒🎒🎒🎒📙📙📙📙📙📙📙📙📙📙📙📙📙📙📙📙📙📙🎒🎒🎒🎒🎒
🚙🚙🚙🚙🚙💜💜💜💜💜💜💜💜💜💜💜💜💜💜💜💜💜💜💜💜🚙🚙🚙🚙🚙🚙🌿🌿🌿🌿🌿🌝🌝🌝🌝🌝📙📙📙📙🎒🎒🎒🎒🎒🎒🎒🎒🎒🎒🎒📙📙📙📙📙📙📙📙📙📙📙📙📙📙📙📙📙📙📙📙🎒🎒🎒🎒
🚙🚙🚙🚙🚙💜💜💜💜💜💜💜💜💜💜💜💜💜💜💜💜💜💜💜💜🚙🚙🚙🚙🚙🚙🌿🌿🌿🌿🌿🌝🌝🌝🌝📙📙📙📙📙🎒🎒🎒🎒🎒🎒🎒🎒🎒🎒📙📙📙📙📙📙📙📙📙📙📙📙📙📙📙📙📙📙📙📙📙📙🎒🎒🎒
🚙🚙🚙🚙🚙💜💜💜💜💜💜💜💜💜💜💜💜💜💜💜💜💜💜💜💜🚙🚙🚙🚙🚙🚙🌿🌿🌿🌿🌿🌝🌝🌝🌝📙📙📙📙🎒🎒🎒🎒🎒🎒🎒🎒🎒🎒📙📙📙📙📙📙📙📙📙📙📙🌝🌝📙📙📙📙📙📙📙📙📙📙📙📙🎒
🚙🚙🚙🚙🚙💜💜💜💜💜💜💜💜💜💜💜💜💜💜💜💜💜💜💜💜🚙🚙🚙🚙🚙🚙🌿🌿🌿🌿🌝🌝🌝🌝🌝📙📙📙📙🎒🎒🎒🎒🎒🎒🎒🎒🎒📙📙📙📙📙📙📙🌝🌝🌝🌝🌝🌝🌝🌝🌝🌝🌝📙📙📙📙📙📙📙📙📙
🚙🚙🚙🚙🚙💜💜💜💜💜💜💜💜💜💜💜💜💜💜💜💜💜💜💜💜🚙🚙🚙🚙🚙🚙🌿🌿🌿🌿🌝🌝🌝🌝📙📙📙📙🎒🎒🎒🎒🎒🎒🎒🎒🎒📙📙📙📙📙📙🌝🌝🌝🌝🌝🌝🌝🌝🌝🌝🌝🌝🌝🌝🌝📙📙📙📙📙📙📙
🚙🚙🚙🚙🚙🚙💜💜💜💜💜💜💜💜💜💜💜💜💜💜💜💜💜💜💜🚙🚙🚙🚙🚙🌿🌿🌿🌿🌿🌝🌝🌝🌝📙📙📙🎒🎒🎒🎒🎒🎒🎒🎒🎒📙📙📙📙📙📙🌝🌝🌝🌝🌝🌝🌝🌝🌝🌝🌝🌝🌝🌝🌝🌝🌝🌝📙📙📙📙📙
🚙🚙🚙🚙🚙🚙🚙💜💜💜💜💜💜💜💜💜💜💜💜💜💜💜💜💜🚙🚙🚙🚙🚙🚙🌿🌿🌿🌿🌝🌝🌝🌝📙📙📙📙🎒🎒🎒🎒🎒🎒🎒🎒📙📙📙📙📙🌝🌝🌝🌝🌝🌝🌝🌝🌝🌝🌝🌝🌝🌝🌝🌝🌝🌝🌝🌝🌝📙📙📙📙
🌿🚙🚙🚙🚙🚙🚙🚙💜💜💜💜💜💜💜💜💜💜💜💜💜💜💜🚙🚙🚙🚙🚙🚙🌿🌿🌿🌿🌿🌝🌝🌝🌝📙📙📙🎒🎒🎒🎒🎒🎒🎒🎒📙📙📙📙📙🌝🌝🌝🌝🌝🌝🌝🌝🌿🌿🌿🌿🌿🌿🌝🌝🌝🌝🌝🌝🌝🌝🌝📙📙📙
🌿🌿🚙🚙🚙🚙🚙🚙🚙💜💜💜💜💜💜💜💜💜💜💜💜💜💜🚙🚙🚙🚙🚙🚙🌿🌿🌿🌿🌝🌝🌝🌝📙📙📙📙🎒🎒🎒🎒🎒🎒🎒📙📙📙📙📙🌝🌝🌝🌝🌝🌝🌿🌿🌿🌿🌿🌿🌿🌿🌿🌿🌿🌿🌝🌝🌝🌝🌝🌝🌝🌝📙
🌿🌿🌿🚙🚙🚙🚙🚙🚙🚙💜💜💜💜💜💜💜💜💜💜💜🚙🚙🚙🚙🚙🚙🚙🌿🌿🌿🌿🌿🌝🌝🌝📙📙📙📙🎒🎒🎒🎒🎒🎒🎒📙📙📙📙📙🌝🌝🌝🌝🌝🌿🌿🌿🌿🌿🌿🌿🌿🌿🌿🌿🌿🌿🌿🌿🌿🌝🌝🌝🌝🌝🌝🌝
🌿🌿🌿🌿🚙🚙🚙🚙🚙🚙🚙🚙💜💜💜💜💜💜💜💜🚙🚙🚙🚙🚙🚙🚙🌿🌿🌿🌿🌿🌝🌝🌝🌝📙📙📙🎒🎒🎒🎒🎒🎒🎒📙📙📙📙🌝🌝🌝🌝🌝🌿🌿🌿🌿🌿🌿🌿🌿🌿🌿🌿🌿🌿🌿🌿🌿🌿🌿🌿🌿🌝🌝🌝🌝🌝
🌿🌿🌿🌿🌿🚙🚙🚙🚙🚙🚙🚙🚙🚙🚙🚙🚙🚙🚙🚙🚙🚙🚙🚙🚙🚙🌿🌿🌿🌿🌿🌝🌝🌝🌝📙📙📙📙🎒🎒🎒🎒🎒🎒🎒📙📙📙🌝🌝🌝🌝🌝🌿🌿🌿🌿🌿🌿🌿🌿🚙🚙🚙🚙🚙🌿🌿🌿🌿🌿🌿🌿🌿🌿🌝🌝🌝🌝
🌝🌿🌿🌿🌿🌿🌿🚙🚙🚙🚙🚙🚙🚙🚙🚙🚙🚙🚙🚙🚙🚙🚙🚙🚙🌿🌿🌿🌿🌿🌝🌝🌝🌝📙📙📙📙🎒🎒🎒🎒🎒🎒🎒📙📙📙🌝🌝🌝🌝🌝🌿🌿🌿🌿🌿🌿🚙🚙🚙🚙🚙🚙🚙🚙🚙🚙🚙🚙🌿🌿🌿🌿🌿🌿🌿🌝🌝
🌝🌝🌿🌿🌿🌿🌿🌿🚙🚙🚙🚙🚙🚙🚙🚙🚙🚙🚙🚙🚙🚙🚙🚙🌿🌿🌿🌿🌿🌝🌝🌝🌝🌝📙📙📙🎒🎒🎒🎒🎒🎒🎒📙📙📙📙🌝🌝🌝🌝🌿🌿🌿🌿🌿🚙🚙🚙🚙🚙🚙🚙🚙🚙🚙🚙🚙🚙🚙🚙🚙🌿🌿🌿🌿🌿🌿🌝
🌝🌝🌝🌝🌿🌿🌿🌿🌿🌿🚙🚙🚙🚙🚙🚙🚙🚙🚙🚙🚙🚙🌿🌿🌿🌿🌿🌿🌝🌝🌝🌝🌝📙📙📙🎒🎒🎒🎒🎒🎒🎒📙📙📙📙🌝🌝🌝🌝🌿🌿🌿🌿🚙🚙🚙🚙🚙🚙🚙🚙🚙🚙🚙🚙🚙🚙🚙🚙🚙🚙🚙🌿🌿🌿🌿🌿🌿
🌝🌝🌝🌝🌝🌿🌿🌿🌿🌿🌿🌿🌿🚙🚙🚙🚙🚙🚙🚙🌿🌿🌿🌿🌿🌿🌿🌝🌝🌝🌝🌝📙📙📙📙🎒🎒🎒🎒🎒🎒📙📙📙📙🌝🌝🌝🌿🌿🌿🌿🌿🚙🚙🚙🚙🚙🚙🚙🚙💜💜💜💜💜🚙🚙🚙🚙🚙🚙🚙🚙🚙🌿🌿🌿🌿
📙🌝🌝🌝🌝🌝🌝🌿🌿🌿🌿🌿🌿🌿🌿🌿🌿🌿🌿🌿🌿🌿🌿🌿🌿🌿🌝🌝🌝🌝🌝📙📙📙📙🎒🎒🎒🎒🎒🎒📙📙📙📙🌝🌝🌝🌿🌿🌿🌿🌿🚙🚙🚙🚙🚙🚙💜💜💜💜💜💜💜💜💜💜💜🚙🚙🚙🚙🚙🚙🚙🌿🌿🌿
📙📙📙🌝🌝🌝🌝🌝🌿🌿🌿🌿🌿🌿🌿🌿🌿🌿🌿🌿🌿🌿🌿🌿🌿🌝🌝🌝🌝🌝📙📙📙📙🎒🎒🎒🎒🎒🎒🎒📙📙📙🌝🌝🌝🌝🌿🌿🌿🌿🚙🚙🚙🚙🚙💜💜💜💜💜💜💜💜💜💜💜💜💜💜💜🚙🚙🚙🚙🚙🚙🌿🌿
📙📙📙📙🌝🌝🌝🌝🌝🌝🌿🌿🌿🌿🌿🌿🌿🌿🌿🌿🌿🌿🌿🌝🌝🌝🌝🌝🌝📙📙📙📙🎒🎒🎒🎒🎒🎒🎒📙📙📙🌝🌝🌝🌝🌿🌿🌿🚙🚙🚙🚙🚙💜💜💜💜💜💜💜💜💜💜💜💜💜💜💜💜💜💜🚙🚙🚙🚙🚙🚙🌿
🎒📙📙📙📙📙🌝🌝🌝🌝🌝🌝🌝🌝🌿🌿🌿🌿🌿🌿🌝🌝🌝🌝🌝🌝🌝🌝📙📙📙📙🎒🎒🎒🎒🎒🎒🎒📙📙📙🌝🌝🌝🌝🌿🌿🌿🚙🚙🚙🚙🚙💜💜💜💜💜💜💜💜💜💜💜💜💜💜💜💜💜💜💜💜💜🚙🚙🚙🚙🌿
🎒🎒🎒📙📙📙📙📙🌝🌝🌝🌝🌝🌝🌝🌝🌝🌝🌝🌝🌝🌝🌝🌝🌝🌝📙📙📙📙📙🎒🎒🎒🎒🎒🎒🎒📙📙📙🌝🌝🌝🌝🌿🌿🌿🚙🚙🚙🚙🚙💜💜💜💜💜💜💜💜💜💜💜💜💜💜💜💜💜💜💜💜💜💜💜🚙🚙🚙🚙
🎒🎒🎒🎒📙📙📙📙📙📙🌝🌝🌝🌝🌝🌝🌝🌝🌝🌝🌝🌝🌝🌝📙📙📙📙📙📙🎒🎒🎒🎒🎒🎒🎒📙📙📙📙🌝🌝🌝🌿🌿🌿🌿🚙🚙🚙🚙💜💜💜💜💜💜💜💜💜💜💜💜💜💜💜💜💜💜💜💜💜💜💜💜🚙🚙🚙🚙
🎒🎒🎒🎒🎒🎒📙📙📙📙📙📙🌝🌝🌝🌝🌝🌝🌝🌝🌝🌝📙📙📙📙📙📙📙🎒🎒🎒🎒🎒🎒🎒📙📙📙📙🌝🌝🌝🌿🌿🌿🌿🚙🚙🚙🚙💜💜💜💜💜💜💜💜💜💜💜💜💜💜💜💜💜💜💜💜💜💜💜💜💜💜🚙🚙🚙
🎒🎒🎒🎒🎒🎒🎒📙📙📙📙📙📙📙📙📙📙📙📙📙📙📙📙📙📙📙📙🎒🎒🎒🎒🎒🎒🎒🎒🎒📙📙📙🌝🌝🌝🌿🌿🌿🌿🚙🚙🚙🚙💜💜💜💜💜💜💜💜💜💜💜💜💜💜💜💜💜💜💜💜💜💜💜💜💜💜💜💜🚙🚙
🎒🎒🎒🎒🎒🎒🎒🎒🎒📙📙📙📙📙📙📙📙📙📙📙📙📙📙📙📙📙🎒🎒🎒🎒🎒🎒🎒🎒🎒📙📙📙🌝🌝🌝🌝🌿🌿🌿🚙🚙🚙🚙💜💜💜💜💜💜💜💜💜💜💜💜💜🚙🚙🚙🚙💜💜💜💜💜💜💜💜💜💜💜💜💜🚙
📙🎒🎒🎒🎒🎒🎒🎒🎒🎒🎒📙📙📙📙📙📙📙📙📙📙📙📙📙🎒🎒🎒🎒🎒🎒🎒🎒🎒🎒📙📙📙🌝🌝🌝🌝🌿🌿🌿🚙🚙🚙🚙💜💜💜💜💜💜💜💜💜💜💜🚙🚙🚙🚙🚙🚙🚙🚙🚙💜💜💜💜💜💜💜💜💜💜💜🚙
📙📙🎒🎒🎒🎒🎒🎒🎒🎒🎒🎒🎒🎒🎒📙📙📙📙📙🎒🎒🎒🎒🎒🎒🎒🎒🎒🎒🎒🎒🎒📙📙📙🌝🌝🌝🌝🌿🌿🌿🚙🚙🚙🚙💜💜💜💜💜💜💜💜💜💜🚙🚙🚙🚙🚙🚙🚙🚙🚙🚙🚙🚙💜💜💜💜💜💜💜💜💜💜💜
📙📙📙📙🎒🎒🎒🎒🎒🎒🎒🎒🎒🎒🎒🎒🎒🎒🎒🎒🎒🎒🎒🎒🎒🎒🎒🎒🎒🎒🎒🎒📙📙📙📙🌝🌝🌝🌿🌿🌿🌿🚙🚙🚙💜💜💜💜💜💜💜💜💜💜🚙🚙🚙🚙🚙🚙🚙🚙🚙🚙🚙🚙🚙🚙🚙💜💜💜💜💜💜💜💜💜
🌝📙📙📙📙🎒🎒🎒🎒🎒🎒🎒🎒🎒🎒🎒🎒🎒🎒🎒🎒🎒🎒🎒🎒🎒🎒🎒🎒🎒🎒📙📙📙📙🌝🌝🌝🌿🌿🌿🌿🚙🚙🚙🚙💜💜💜💜💜💜💜💜💜🚙🚙🚙🚙🚙🚙🚙🚙🚙🚙🚙🚙🚙🚙🚙🚙💜💜💜💜💜💜💜💜💜
🌝🌝📙📙📙📙📙🎒🎒🎒🎒🎒🎒🎒🎒🎒🎒🎒🎒🎒🎒🎒🎒🎒🎒🎒🎒🎒🎒📙📙📙📙📙🌝🌝🌝🌝🌿🌿🌿🚙🚙🚙🚙💜💜💜💜💜💜💜💜💜🚙🚙🚙🚙🚙🚙🚙🚙🚙🚙🚙🚙🚙🚙🚙🚙🚙🚙💜💜💜💜💜💜💜💜
🌝🌝🌝🌝📙📙📙📙🎒🎒🎒🎒🎒🎒🎒🎒🎒🎒🎒🎒🎒🎒🎒🎒🎒🎒🎒🎒📙📙📙📙📙🌝🌝🌝🌝🌿🌿🌿🌿🚙🚙🚙💜💜💜💜💜💜💜💜💜🚙🚙🚙🚙🚙🚙🚙🚙🚙🚙🚙🚙🚙🚙🚙🚙🚙🚙🚙💜💜💜💜💜💜💜💜
🌿🌝🌝🌝🌝📙📙📙📙📙🎒🎒🎒🎒🎒🎒🎒🎒🎒🎒🎒🎒🎒🎒🎒🎒🎒📙📙📙📙📙🌝🌝🌝🌝🌿🌿🌿🌿🚙🚙🚙🚙💜💜💜💜💜💜💜💜🚙🚙🚙🚙🚙🚙🚙🚙🚙🚙🚙🚙🚙🚙🚙🚙🚙🚙🚙🚙🚙💜💜💜💜💜💜💜
🌿🌿🌝🌝🌝🌝📙📙📙📙📙📙🎒🎒🎒🎒🎒🎒🎒🎒🎒🎒🎒🎒🎒📙📙📙📙📙📙🌝🌝🌝🌝🌿🌿🌿🌿🚙🚙🚙🚙💜💜💜💜💜💜💜💜💜🚙🚙🚙🚙🚙🚙🚙🚙🌿🌿🌿🌿🌿🌿🚙🚙🚙🚙🚙🚙🚙💜💜💜💜💜💜💜
🌿🌿🌿🌝🌝🌝🌝🌝📙📙📙📙📙📙📙🎒🎒🎒🎒🎒🎒🎒📙📙📙📙📙📙📙📙🌝🌝🌝🌝🌿🌿🌿🌿🚙🚙🚙🚙💜💜💜💜💜💜💜💜💜🚙🚙🚙🚙🚙🚙🚙🌿🌿🌿🌿🌿🌿🌿🌿🚙🚙🚙🚙🚙🚙🚙🚙💜💜💜💜💜💜
🌿🌿🌿🌿🌝🌝🌝🌝🌝📙📙📙📙📙📙📙📙📙📙📙📙📙📙📙📙📙📙📙📙🌝🌝🌝🌝🌝🌿🌿🌿🌿🚙🚙🚙🚙💜💜💜💜💜💜💜💜🚙🚙🚙🚙🚙🚙🚙🌿🌿🌿🌿🌿🌿🌿🌿🌿🌿🚙🚙🚙🚙🚙🚙🚙💜💜💜💜💜💜
🚙🌿🌿🌿🌿🌿🌝🌝🌝🌝🌝📙📙📙📙📙📙📙📙📙📙📙📙📙📙📙📙🌝🌝🌝🌝🌝🌝🌿🌿🌿🌿🚙🚙🚙🚙💜💜💜💜💜💜💜💜💜🚙🚙🚙🚙🚙🚙🚙🌿🌿🌿🌿🌿🌿🌿🌿🌿🌿🚙🚙🚙🚙🚙🚙🚙💜💜💜💜💜💜
🚙🚙🌿🌿🌿🌿🌿🌝🌝🌝🌝🌝🌝📙📙📙📙📙📙📙📙📙📙📙📙🌝🌝🌝🌝🌝🌝🌝🌿🌿🌿🌿🚙🚙🚙🚙🚙💜💜💜💜💜💜💜💜🚙🚙🚙🚙🚙🚙🚙🌿🌿🌿🌿🌿🌿🌿🌿🌿🌿🌿🌿🚙🚙🚙🚙🚙🚙💜💜💜💜💜💜
🚙🚙🚙🚙🌿🌿🌿🌿🌝🌝🌝🌝🌝🌝🌝🌝📙📙📙📙📙📙📙🌝🌝🌝🌝🌝🌝🌝🌝🌿🌿🌿🌿🌿🚙🚙🚙🚙💜💜💜💜💜💜💜💜💜🚙🚙🚙🚙🚙🚙🌿🌿🌿🌿🌿🌿🌿🌿🌿🌿🌿🌿🌿🚙🚙🚙🚙🚙🚙💜💜💜💜💜💜
🚙🚙🚙🚙🚙🌿🌿🌿🌿🌝🌝🌝🌝🌝🌝🌝🌝🌝🌝🌝🌝🌝🌝🌝🌝🌝🌝🌝🌝🌝🌿🌿🌿🌿🌿🚙🚙🚙🚙💜💜💜💜💜💜💜💜💜💜🚙🚙🚙🚙🚙🚙🌿🌿🌿🌿🌿🌿🌿🌿🌿🌿🌿🌿🌿🚙🚙🚙🚙🚙🚙💜💜💜💜💜💜
💜💜🚙🚙🚙🚙🌿🌿🌿🌿🌿🌝🌝🌝🌝🌝🌝🌝🌝🌝🌝🌝🌝🌝🌝🌝🌝🌝🌿🌿🌿🌿🌿🌿🚙🚙🚙🚙🚙💜💜💜💜💜💜💜💜💜🚙🚙🚙🚙🚙🚙🚙🌿🌿🌿🌿🌿🌿🌿🌿🌿🌿🌿🌿🌿🚙🚙🚙🚙🚙🚙💜💜💜💜💜💜
